latintext	translation	translator
Marcus Tullius Cicero Epistulae ad Atticum – Liber VI	Cícero Cartas a Ático – Livro 6	José Dejalma Dezotti
-----	-----	José Dejalma Dezotti
TRADUÇÃO: **José Dejalma Dezotti**		José Dejalma Dezotti
		José Dejalma Dezotti
**1**	**1**	José Dejalma Dezotti
Cicero Attico sal.	Cícero saúda Ático.	José Dejalma Dezotti
**1** Accepi tuas litteras a. d. V Terminalia Laodiceae, quas legi libentissime plenissimas amoris, humanitatis, offici, diligentiae.	**1** Recebi tua carta em Laodicéia cinco dias antes das Terminais, a qual li com muitíssimo prazer, tão cheia estava ela de afeto, de humanidade, de dever, de diligência.	José Dejalma Dezotti
Iis igitur respondebo, (sic enim postulas), nec οἰκονομίαν meam instituam sed ordinem conseruabo tuum.	Vou, pois, respondê-la (pois assim me pedes) e não vou estabelecer o meu próprio *plano*, mas manterei a tua ordem.	José Dejalma Dezotti
Recentissimas a Cybistris te meas litteras habere ais a. d. X Kal. Oct. datas et scire uis tuas ego quas acceperim.	Dizes que tens, como carta mais recente minha, a que foi enviada de Cibistra no décimo dia antes das calendas de outubro \[22 de setembro\] e queres saber quais tuas eu recebi.	José Dejalma Dezotti
Omnis fere quas commemoras, praeter eas quas scribis Lentuli pueris et quas Equo Tutico et Brundisio datas.	Quase todas que mencionas, exceto aquelas que, segundo escreves, foram entregues aos escravos de Lêntulo e as que foram enviadas de Equo Tutico e Brundísio.	José Dejalma Dezotti
Qua re non οἴχεται tua industria, quod uereris, sed praeclare ponitur, si quidem id egisti, ut ego delectarer;	Por isso teu zelo não *está perdido*, como receias, mas se põe magnificamente, se na verdade fizeste isso para que eu me deleitasse;	José Dejalma Dezotti
nam nulla re sum delectatus magis.	pois com nada eu me deleitei mais.	José Dejalma Dezotti
**2** Quod meam βαθύτητα in Appio tibi, liberalitatem etiam in Bruto probo, uehementer gaudeo;	**2** Me alegra muitíssimo que aproves minha *sagacidade* em relação a Ápio, e também a minha generosidade em relação a Bruto;	José Dejalma Dezotti
ac putaram paulo secus.	e eu tinha pensado que ia ser um pouco diferente.	José Dejalma Dezotti
Appius enim ad me ex itinere bis terue ὑπομεμψιμοίρους litteras miserat quod quaedam a se constituta rescinderem.	Pois Ápio, em sua viagem, tinha enviado duas ou três cartas *cheias de queixas*, porque eu tinha anulado algumas coisas estabelecidas por ele.	José Dejalma Dezotti
Vt si medicus, cum aegrotus alii medico traditus sit, irasci uelit ei medico qui sibi successerit si quae ipse in curando constituerit immutet ille, sic Appius, cum ἐξ ἀφαιρέσεως prouinciam curarit, sanguinem miserit, quicquid potuit detraxerit, mihi tradiderit enectam, προσανατρεφομένην eam a me non libenter uidet sed modo suscenset, et modo gratias agit.	Assim como se um médico, quando o doente foi confiado a outro médico, quisesse irritar-se com esse médico que o sucedeu, caso ele mude algo que ele próprio estabeleceu para curá-lo, assim também Ápio, depois de ter cuidado da província *mediante extirpações*, de tê-la sangrado, de ter roubado tudo o que pôde, de tê-la entregado a mim esgotada, não vê de bom grado ela *sendo revigorada de novo* por mim, mas ora fica irritado, ora me agradece.	José Dejalma Dezotti
Nihil enim a me fit cum ulla illius contumelia;	Pois nada foi feito por mim com qualquer ofensa a ele;	José Dejalma Dezotti
tantum modo dissimilitudo meae rationis offendit hominem.	somente a diferença de meu método ofende o homem.	José Dejalma Dezotti
Quid enim potest esse tam dissimile quam illo imperante exhaustam esse sumptibus et iacturis prouinciam, nobis eam obtinentibus nummum nullum esse erogatum nec priuatim nec publice?	Pois o que pode ser tão diferente quanto a província ter sido arruinada com gastos e despesas, enquanto ele a governava, quando nós a obtivemos, não ter sido gasta nenhuma moeda nem privadamente nem públicamente?	José Dejalma Dezotti
Quid dicam de illius praefectis, comitibus, legatis etiam?	O que vou dizer ainda de seus prefeitos, acompanhantes, legados?	José Dejalma Dezotti
De rapinis, de libidinibus, de contumeliis?	Das rapinas, das paixões, das ofensas?	José Dejalma Dezotti
Nunc autem domus mehercule nulla tanto consilio aut tanta disciplina gubernatur aut tam modesta est quam nostra tota prouincia.	Já agora nenhuma casa \- por hércules \- é governada com tanto juízo ou com tanta disciplina ou está tão moderada quanto a nossa província inteira.	José Dejalma Dezotti
Haec non nulli amici Appi ridicule interpretantur, qui me idcirco putent bene audire uelle ut ille male audiat et recte facere non meae laudis sed illius contumeliae causa.	Alguns amigos de Ápio interpretam isto de modo ridículo: eles julgam que eu, neste caso, quero ter boa fama para que ele tenha má e que ajo com retidão não para o meu louvor, mas para a sua desonra.	José Dejalma Dezotti
Sin Appius, ut Bruti litterae quas ad te misit significabant, gratias nobis agit, non moleste fero, sed tamen eo ipso die quo haec ante lucem scribebam cogitabam eius multa inique constituta et acta tollere.	Mas se Ápio, como indicava a carta de Bruto, que ele enviou a ti, me agradece, não o levo a mal, mas nesse mesmo dia em que escrevo esta antes do amanhecer, penso em anular muitas coisas dele estabelecidas e realizadas de modo injusto.	José Dejalma Dezotti
**3** Nunc uenio ad Brutum, quem ego omni studio te auctore sum complexus, quem etiam amare coeperam;	**3** Agora venho a Bruto, a quem eu, a teu conselho, acolhi com todo interesse, a quem também eu tinha começado a estimar;	José Dejalma Dezotti
sed plane dico, me reuocaui ne te offenderem.	mas digo com franqueza, voltei atrás para não te ofender.	José Dejalma Dezotti
Noli enim putare me quicquam maluisse quam ut mandatis satis facerem nec ulla de re plus laborasse.	Pois não julgues que eu tenha querido algo mais do que satisfazer os seus encargos e que em relação a nenhuma outra coisa eu tenho me esforçado mais.	José Dejalma Dezotti
Mandatorum autem mihi libellum dedit, isdemque de rebus tu mecum egeras.	Ele, por sua vez, me deu uma lista de encargos e sobre essas mesmas coisas tu tinhas tratado comigo.	José Dejalma Dezotti
Omnia sum diligentissime persecutus.	Levei tudo a cabo com a maior presteza.	José Dejalma Dezotti
Primum ab Ariobarzane sic contendi, ut talenta quae mihi pollicebatur illi daret.	Em primeiro lugar, pedi a Ariobárzanes que ele lhe desse os talentos que me prometia.	José Dejalma Dezotti
Quoad mecum rex fuit, perbono loco res erat;	Enquanto o rei esteve comigo, a coisa estava em excelente situação;	José Dejalma Dezotti
post a Pompei procuratoribus sescentis premi coeptus est.	depois ele começou a ser pressionado por seiscentos procuradores de Pompeu.	José Dejalma Dezotti
Pompeius autem cum ob ceteras causas plus potest unus quam ceteri omnes, tum quod putatur ad bellum Parthicum esse uenturus.	E Pompeu sozinho tem, por diversas razões, mais poder que todos os outros, mas principalmente porque se julga que ele virá para a guerra contra os partos.	José Dejalma Dezotti
Ei tamen sic nunc soluitur:	A ele, contudo, se paga assim agora:	José Dejalma Dezotti
tricesimo quoque die talenta Attica XXXIII, et hoc ex tributis;	cada trinta dias trinta e três talentos áticos, e isto sai dos impostos;	José Dejalma Dezotti
nec id satis efficitur in usuram menstruam.	e isso não cobre suficientemente nem o juro mensal.	José Dejalma Dezotti
Sed Gnaeus noster clementer id fert;	Mas o nosso amigo Cneu suporta isso com clemência;	José Dejalma Dezotti
sorte caret, usura nec ea solida contentus est.	não tem capital, e se contenta com esse lucro não sólido.	José Dejalma Dezotti
Alii neque soluit cuiquam nec potest soluere;	Ele (o rei) não para a nenhum outro nem pode pagar;	José Dejalma Dezotti
nullum enim aerarium, nullum uectigal habet.	pois não tem nenhum erário, nenhum imposto.	José Dejalma Dezotti
Appi instituto tributa imperat;	exige tributos com a regulamentação de Ápio;	José Dejalma Dezotti
ea uix in faenus Pompei quod satis sit efficiunt.	esses mal são suficientes para cobrir o rendimento de Pompeu.	José Dejalma Dezotti
Amici regis duo tresue perdiuites sunt, sed ii suum tam diligenter tenent quam ego aut tu.	Dois ou três amigos do rei são muito ricos, mas esses mantêm o seu com tanto empenho quanto eu ou tu.	José Dejalma Dezotti
Equidem non desino tamen per litteras rogare, suadere, accusare regem.	Na verdade, não deixo, contudo, de rogar, de persuadir, de repreender o rei, por cartas.	José Dejalma Dezotti
**4** Deiotarus etiam mihi narrauit se ad eum legatos misisse de re Bruti;	**4** Dejótaro me contou também que enviou legados a ele a respeito do caso de Bruto;	José Dejalma Dezotti
eos sibi responsum rettulisse illum non habere.	que eles lhe trouxeram a resposta de que ele não tinha.	José Dejalma Dezotti
Et mehercule ego ita iudico, nihil illo regno spoliatius, nihil rege egentius.	E, por hércules, eu também julgo assim, não há nada mais espoliado do que aquele reino, nada mais pobre do que o rei.	José Dejalma Dezotti
Itaque aut tutela cogito me abdicare aut, ut pro Glabrione Scaeuola, faenus et impendium recusare.	E assim eu penso ou abdicar de minha tutela ou, como Cévola em favor de Glabrião, rejeitar o lucro e o rendimento.	José Dejalma Dezotti
Ego tamen quas per te Bruto promiseram praefecturas M. Scaptio, L. Gauio, qui in regno rem Bruti procurabant, detuli;	Eu, contudo, concedi as prefeituras que tinha prometido por tua intervenção a Bruto a Marco Escápcio e Lúcio Gávio, que se ocupavam do assunto de Bruto no reino;	José Dejalma Dezotti
nec enim in prouincia mea negotiabantur.	pois não estavam comerciando em minha província.	José Dejalma Dezotti
Tu autem meministi nos sic agere ut quot uellet praefecturas sumeret, dum ne negotiatori;	E tu te lembras de que nós atuamos de tal modo que ele tomasse quantas prefeituras quisesse, desde que não para um comerciante;	José Dejalma Dezotti
itaque duas ei praeterea dederam, sed ii quibus petierat de prouincia decesserant.	e assim lhe dei além disso duas, mas aqueles para os quais ele tinha solicitado tinham ido embora da província.	José Dejalma Dezotti
**5** Nunc cognosce de Salaminis, quod uideo tibi etiam nouum accidisse, tamquam mihi.	**5** Agora inteira-te sobre a gente de Salamina, pois vejo que também a ti te pegou de surpresa tal qual a mim.	José Dejalma Dezotti
Numquam enim ex illo audiui illam pecuniam esse suam;	Pois nunca ouvi dele que o dinheiro era seu;	José Dejalma Dezotti
quin etiam libellum ipsius habeo in quo est “Salamini pecuniam debent M. Scaptio et P. Matinio, familiaribus meis”.	e ainda mais, tenho apontamentos dele em que está: “Os salminos devem dinheiro a Marco Escápcio e Públio Matínio, amigos meus”.	José Dejalma Dezotti
Eos mihi commendat;	Ele os recomenda a mim;	José Dejalma Dezotti
adscribit etiam et quasi calcar admouet intercessisse se pro iis magnam pecuniam.	acrescenta ainda, e, por assim dizer, me estimula, que interpôs em favor deles uma grande quantia.	José Dejalma Dezotti
Confeceram ut soluerent centesimis †sexenni† ductis cum renouatione singulorum annorum.	Eu consegui que pagassem juros de um por cento mensal com acumulação de juros cada ano.	José Dejalma Dezotti
At Scaptius quaternas postulabat.	Mas Escápcio pedia quatro por cento.	José Dejalma Dezotti
Metui, si impetrasset, ne tu ipse me amare desineres;	Tive medo de que, se ele conseguisse, tu próprio deixarias de gostar de mim;	José Dejalma Dezotti
nam ab edicto meo recessissem et ciuitatem in Catonis et in ipsius Bruti fide locatam meisque beneficiis ornatam funditus perdidissem.	pois eu teria me afastado de meu edito e teria arruinado completamente uma cidade colocada sob a proteção de Catão e do próprio Bruto e provida de meus favores.	José Dejalma Dezotti
**6** Atque hoc tempore ipso impingit mihi epistulam Scaptius a Bruto rem illam suo periculo esse, quod nec mihi umquam Brutus dixerat nec tibi, etiam ut praefecturam Scaptio deferrem.	**6** E neste mesmo momento Escápcio me lança uma carta de Bruto: que aquele assunto o afetava, o que Bruto nunca dissera nem a mim nem a ti, que também concedesse a prefeitura a Escápcio.	José Dejalma Dezotti
Id uero per te exceperamus, ne negotiatori;	Mas, por teu intermédio, tínhamos feito uma exceção, a nenhum comerciante;	José Dejalma Dezotti
quod si cuiquam, huic tamen non.	e se a algum, a este, contudo, não.	José Dejalma Dezotti
Fuerat enim praefectus Appio, et quidem habuerat turmas equitum, quibus inclusum in curia senatum Salamine obsederat, ut fame senatores quinque morerentur.	Pois tinha sido prefeito de Ápio e tinha tido esquadrões de cavalarias, com os quais tinha sitiado em Salamina o senado encerrado na cúria, de modo que cinco senadores morreram de fome.	José Dejalma Dezotti
Itaque ego, quo die tetigi prouinciam, cum mihi Cyprii legati Ephesum obuiam uenissent, litteras misi ut equites ex insula statim decederent.	E assim eu, no dia em pus o pé na província, quando os legados de Chipre tinham vindo ao meu encontro em Éfeso, mandei uma carta para que os cavaleiros fossem imediatamente embora da ilha.	José Dejalma Dezotti
His de causis credo Scaptium iniquius de me aliquid ad Brutum scripsisse.	Por causa dessas coisas, creio que Escápcio escreveu a Bruto algo mais injusto sobre mim.	José Dejalma Dezotti
Sed tamen hoc sum animo:	Mas, mesmo assim, estou com este ânimo:	José Dejalma Dezotti
si Brutus putabit me quaternas centesimas oportuisse decernere, cum tota prouincia singulas obseruarem itaque edixissem idque etiam acerbissimis faeneratoribus probaretur, si praefecturam negotiatori denegatam queretur, quod ego Torquato nostro in tuo Laenio, Pompeio ipsi in Sex. Statio negaui et iis probaui, si equites deductos moleste feret, accipiam equidem dolorem mihi illum irasci sed multo maiorem non esse eum talem qualem putassem.	se Bruto julgar que me era necessário decretar quatro por cento, quando em toda a província eu mantinha um por cento e assim eu tinha editado e isso era até mesmo aprovado pelos mais rigorosos prestamistas, se se queixar de que tenha sido denegada a um comerciante a prefeitura, pois eu neguei ao nosso Torquato no caso de teu amigo Lênio, ao próprio Pompeu no caso de Sexto Estácio e obtive a aprovação deles, se levar a mal a retirada dos cavaleiros, vou sofrer, sem dúvida, por ele estar irritado comigo, mas vou sofrer muito mais por ele não ser tal e qual eu o julgava.	José Dejalma Dezotti
**7** Illud quidem fatebitur Scaptius, me ius dicente sibi omnem pecuniam ex edicto meo auferendi potestatem fuisse.	**7** Em todo caso, Escápcio reconhecerá isto: que, enquanto eu administrava a justiça, ele teve a possibilidade de auferir todo o dinheiro, de acordo com meu edito.	José Dejalma Dezotti
Addo etiam illud, quod uereor tibi ipsi ut probem:	Acrescento ainda algo que temo que nem mesmo de ti eu tenha aprovação:	José Dejalma Dezotti
consistere usura debuit, quae erat in edicto meo;	os juros, que havia em meu edito, deviam cessar;	José Dejalma Dezotti
deponere uolebant:	queriam fazer o depósito:	José Dejalma Dezotti
impetraui a Salaminis ut silerent.	obtive dos salamínios que calassem.	José Dejalma Dezotti
Veniam illi quidem mihi dederunt, sed quid iis fiet si huc Paulus uenerit?	Eles me fizeram esse favor, mas o que acontecerá a eles se Paulo vier aqui?	José Dejalma Dezotti
Sed totum hoc Bruto dedi;	Mas eu concedi tudo isto a Bruto;	José Dejalma Dezotti
qui de me ad te humanissimas litteras scripsit, ad me autem, etiam cum rogat aliquid, contumaciter, adroganter, ἀκοινονοήτως solet scribere.	e ele te escreveu uma carta muito compreensiva sobre mim, a mim, porém, mesmo quando pede algo, costuma escrever de modo contumaz, arrogante, *sem sentido comum*.	José Dejalma Dezotti
Tu autem uelim ad eum scribas de his rebus, ut sciam quo modo haec accipiat; facies enim me certiorem.	Tu, porém, eu gostaria que escrevesses a ele sobre essas coisas, para que eu saiba como ele toma isso; pois tu me informarás.	José Dejalma Dezotti
Atque haec superioribus litteris diligenter ad te perscripseram, sed plane te intellegere uolui mihi non excidisse illud quod tu ad me quibusdam litteris scripsisses, si nihil aliud de hac prouincia nisi illius beneuolentiam deportassem, mihi id satis esse.	E, em carta anterior, eu te havia escrito isto detalhadamente, mas quis que compreendesses claramente que não me esqueci daquilo que tu me tinhas escrito em um determinada carta: se eu não tivesse levado desta província nenhuma outra coisa a não ser a boa disposição dele, isso me seria suficiente.	José Dejalma Dezotti
Sit sane, quoniam ita tu uis, sed tamen cum eo, credo, quod sine peccato meo fiat.	Que seja, já que tu queres assim, mas contudo, creio, com a condição de que se faça sem transgressão minha.	José Dejalma Dezotti
Igitur meo decreto soluta res Scaptio statim.	Portanto, por meu decreto, a coisa foi imediatamente resolvida para Escápcio.	José Dejalma Dezotti
Quam id rectum sit tu iudicabis;	O quanto isso é justo tu julgarás;	José Dejalma Dezotti
ne ad Catonem quidem prouocabo.	não vou apelar nem mesmo a Catão.	José Dejalma Dezotti
**8** Sed noli me putare ἐγκελεύσματα illa tua abiecisse, quae mihi in uisceribus haerent.	**8** Mas não julgues que eu rechacei aqueles teus *avisos* que estão gravados em minhas vísceras.	José Dejalma Dezotti
Flens mihi meam famam commendasti;	Chorando, me encomendaste a minha reputação;	José Dejalma Dezotti
quae epistula tua est in qua mentionem non facias?	que carta tua há em que não faças menção a ela?	José Dejalma Dezotti
Itaque irascatur qui uolet, patiar;	Por isso que fique irritado quem quiser, eu suportarei;	José Dejalma Dezotti
“τὸ γὰρ εὖ μετ' ἐμοῦ”, praesertim cum sex libris tamquam praedibus me ipse obstrinxerim, quos tibi tam ualde probari gaudeo.	“*pois o bem está do meu lado*”, principalmente quando eu próprio me sujeitei a seis livros como garantias, os quais fico contente que sejam tão grandemente aprovados por ti.	José Dejalma Dezotti
E quibus unum ἱστορικὸν requiris de Cn. Flauio, Anni filio.	Destes perguntas um único ponto histórico a respeito de Cneu Flávio, filho de Ânio.	José Dejalma Dezotti
Ille uero ante decemuiros non fuit, quippe qui aedilis curulis fuerit, qui magistratus multis annis post decemuiros institutus est.	Ele, na verdade, não existiu antes dos decênviros, visto que ele foi edil curul, magistratura que foi instituída muitos anos depois dos decênviros.	José Dejalma Dezotti
Quid ergo profecit, quod protulit fastos?	De que serviu então o fato de ter publicado o calendário?	José Dejalma Dezotti
Occultatam putant quodam tempore istam tabulam, ut dies agendi peterentur a paucis;	Creem que essa tabuinha esteve oculta por um certo tempo, para que os dias hábeis fossem consultados por poucos;	José Dejalma Dezotti
nec uero pauci sunt auctores Cn. Flauium scribam fastos protulisse actionesque composuisse, ne me hoc uel potius Africanum (is enim loquitur) commentum putes;	e, na verdade, não são poucos os autores que sustentam que o escriba Cneu Flávio publicou o calendário e compôs as ações, não penses que eu ou antes o Africano (pois é ele que fala) inventamos uma ficção;	José Dejalma Dezotti
οὐκ ἔλαθέ σε illud de gestu histrionis?	*não te passou despercebido* aquilo sobre o gesto do ator?	José Dejalma Dezotti
Tu sceleste suspicaris, ego ἀφελῶς scripsi.	Tu suspeitas de modo criminoso, eu escrevi *sem segundas intenções*.	José Dejalma Dezotti
**9** De me imperatore scribis te ex Philotimi litteris cognosse;	**9** A respeito de minha aclamação como imperator, escreves que ficaste sabendo por uma carta de Filótimo;	José Dejalma Dezotti
sed credo te, iam in Epiro cum esses, binas meas de omnibus rebus accepisse, unas a Pindenisso capto, alteras Laodicea, utrasque tuis pueris datas.	mas creio que tu, já que estás em Epiro, recebeu duas minhas sobre todos os assuntos, uma após a tomada de Pindenisso, outra de Laodicéia, ambas entregues a teus escravos.	José Dejalma Dezotti
Quibus de rebus propter casum nauigandi per binos tabellarios misi Romam publice litteras.	Sobre esses assuntos, enviei oficialmente a Roma uma carta por intermédio de dois carteiros por causa dos riscos do mar.	José Dejalma Dezotti
**10** De Tullia mea tibi adsentior scripsique ad eam et ad Terentiam mihi placere;	**10** A respeito de Túlia, estou de acordo contigo e escrevi a ela e a Terência que me agrada;	José Dejalma Dezotti
tu enim ad me iam ante scripseras “ac uellem te in tuum ueterem gregem rettulisses”.	pois tu já tinhas me escrito antes “e eu queria que voltasses ao teu antigo grupo”.	José Dejalma Dezotti
Correcta uero epistula Memmiana nihil negoti fuit;	Corrigida a carta de Mêmio, não houve nenhum problema;	José Dejalma Dezotti
multo enim malo hunc a Pontidia quam illum a Seruilia.	pois eu prefiro em muito este candidato de Pontídia do que aquele de Servília.	José Dejalma Dezotti
Qua re adiunges Saufeium nostrum, hominem semper amantem mei, nunc credo eo magis quod debet etiam fratris Appi amorem erga me cum reliqua hereditate creuisse, qui declarauit quanti me faceret cum saepe tum in Bursa.	Por isso busca o nosso amigo Saufeio, homem que sempre me estimou, agora ainda mais, creio, porque deve ter acrescentado, junto com a herança restante, o afeto de seu irmão Ápio para comigo, o qual declarou frequentemente o quanto me apreciava, especialmente no caso de Bursa.	José Dejalma Dezotti
Ne tu me sollicitudine magna liberaris.	Certamente tu me livrarás de uma grande preocupação.	José Dejalma Dezotti
**11** Furni exceptio mihi non placet; nec enim ego ullum aliud tempus timeo nisi quod ille solum excipit.	**11** A exceção de Fúrnio não me agrada; pois eu não temo nenhum outro período, a não ser o único que ele excetua.	José Dejalma Dezotti
Sed scriberem ad te de hoc plura, si Romae esses.	Mas eu te escreveria mais sobre isso, se estivesses em Roma.	José Dejalma Dezotti
In Pompeio te spem omnem oti ponere non miror;	Não fico surpreso que ponhas em Pompeu toda esperança de paz;	José Dejalma Dezotti
ita res est, remouendumque censeo illud “dissimulantem”.	assim está a coisa e penso que deve ser removido aquele “dissimulando”.	José Dejalma Dezotti
Sed enim οἰκονομία si perturbatior est, tibi adsignato;	Mas, com efeito, se minha *ordem* está mais caótica, pôe em ti a culpa;	José Dejalma Dezotti
te enim sequor σχεδιάζοντα.	pois sigo tuas *improvisações*.	José Dejalma Dezotti
**12** Cicerones pueri amant inter se, discunt, exercentur;	**12** Os meninos Cíceros se estimam entre si, aprendem, se exercitam;	José Dejalma Dezotti
sed alter, ut Isocrates dixit in Ephoro et Theopompo, frenis eget, alter calcaribus.	mas um, como disse Isócrates em relação a Éforo e a Teopompo, precisa de freio, o outro, de espora.	José Dejalma Dezotti
Quinto togam puram Liberalibus cogitabam dare;	Penso em dar a toga branca a Quinto nas Liberalia;	José Dejalma Dezotti
mandauit enim pater.	pois seu pai me encarregou.	José Dejalma Dezotti
Ea sic obseruabo quasi intercalatum non sit.	Vou considerar como se não houvesse intercalação de dia.	José Dejalma Dezotti
Dionysius mihi quidem in amoribus est.	Dionísio goza de minha afeição.	José Dejalma Dezotti
Pueri autem aiunt eum furenter irasci;	Os meninos, porém, dizem que ele fica furiosamente irritado;	José Dejalma Dezotti
sed homo nec doctior nec sanctior fieri potest nec tui meique amantior.	mas não pode haver um homem mais sábio, nem mais virtuoso, nem mais afetuoso contigo e comigo.	José Dejalma Dezotti
**13** Thermum, Silium uere audis laudari;	**13** Ouves que Termo e Sílio são louvados com razão;	José Dejalma Dezotti
ualde se honeste gerunt.	eles se comportam muito honestamente.	José Dejalma Dezotti
Adde M. Nonium, Bibulum, me si uoles.	Acrescenta Marco Nônio, Bíbulo e a mim, se quiseres.	José Dejalma Dezotti
Iam Scrofa uellem haberet ubi posset;	Queria que Escrofa tivesse agora onde tivesse mais poder;	José Dejalma Dezotti
est enim lautum negotium.	pois é um esplêndido indivíduo.	José Dejalma Dezotti
Ceteri firmant πολίτευμα Catonis.	Os demais consolidam *o sistema político* de Catão.	José Dejalma Dezotti
Hortensio quod causam meam commendas ualde gratum.	Por recomendares minha causa a Hortênsio, fico muito agradecido.	José Dejalma Dezotti
De Amiano, spei nihil putat esse Dionysius.	A respeito de Amiano, Dionísio considera não haver nenhuma esperana.	José Dejalma Dezotti
Terenti nullum uestigium agnoui.	Não percebi nenhum vestígio de Terêncio.	José Dejalma Dezotti
Moeragenes certe periit;	Merágenes sem dúvida morreu;	José Dejalma Dezotti
feci iter per eius possessionem, in qua animal reliquum nullum est.	fiz um percurso por sua propriedade e nela não resta nenhum ser vivo.	José Dejalma Dezotti
Haec non noram tum cum de ea re cum Democrito tuo locutus sum.	Isto eu não sabia quando falei sobre essas coisas com o teu Demócrito.	José Dejalma Dezotti
Rhosica uasa mandaui.	Encarreguei as vasilhas de Roso.	José Dejalma Dezotti
Sed heus tu, quid cogitas?	Mas olha lá\! o que estás pensando?	José Dejalma Dezotti
In felicatis lancibus et splendidissimis canistris holusculis nos soles pascere:	Costumas nos alimentar com verdurinhas em pratos cinzelados com folhas de feto e em magníficos cestos:	José Dejalma Dezotti
quid te in uasis fictilibus appositurum putem?	o que eu devo pensar que porás em vasilhas de barro?	José Dejalma Dezotti
κέρας Phemio mandatum est.	Uma flauta foi encarregada a Fêmio.	José Dejalma Dezotti
Reperietur, modo aliquid illo dignum canat.	Será encontrada, desde que cante algo digno dela.	José Dejalma Dezotti
**14** Parthicum bellum inpendet.	**14** É iminente a guerra dos partos.	José Dejalma Dezotti
Cassius ineptas litteras misit, necdum Bibuli erant adlatae;	Cássio enviou uma carta inepta, e a de Bíbulo ainda não chegou;	José Dejalma Dezotti
quibus recitatis puto fore ut aliquando commoueatur senatus.	lidas essas coisas, acho que enfim o senado haverá de se mover.	José Dejalma Dezotti
Equidem sum in magna animi perturbatione.	Na verdade estou numa grande perturbação de ânimo.	José Dejalma Dezotti
Si, ut opto, non prorogatur nostrum negotium, habeo Iunium et Quintilem in metu.	Se, como desejo, minha tarefa não é prorrogada, tenho junho e quintil \[julho\] em medo.	José Dejalma Dezotti
Esto;	Seja;	José Dejalma Dezotti
duo quidem mensis sustinebit Bibulus.	Bíbulo, na verdade, resistirá por dois meses.	José Dejalma Dezotti
Quid illo fiet quem reliquero, praesertim si fratrem?	O que acontecerá com aquele que eu deixar, principalmente se é meu irmão?	José Dejalma Dezotti
Quid me autem, si non tam cito decedo?	E comigo, se não parto tão rápido?	José Dejalma Dezotti
Magna turba est.	É um grande problema.	José Dejalma Dezotti
Mihi tamen cum Deiotaro conuenit ut ille in meis castris esset cum suis copiis omnibus;	Para mim, contudo, convim com Dejótaro para que ele estivesse com todas as suas tropas em meu acampamento;	José Dejalma Dezotti
habet autem cohortis quadringenarias nostra armatura XXX, equitum CI CI.	ele tem trinta coortes de quatrocentos homens, armadas a nosso estilo e dois mil cavaleiros.	José Dejalma Dezotti
Erit ad sustentandum quoad Pompeius ueniat, qui litteris quas ad me mittit significat suum negotium illud fore.	Será para resistir até que Pompeu chegue, ele que em uma carta que me enviou indica que aquela tarefa será sua.	José Dejalma Dezotti
Hiemant in nostra prouincia Parthi;	Os partos passam o inverno em nossa província;	José Dejalma Dezotti
exspectatur ipse Orodes.	Orodes em pessoa é esperado.	José Dejalma Dezotti
Quid quaeris?	O que queres?	José Dejalma Dezotti
Aliquantum est negoti.	Há bastante tarefa.	José Dejalma Dezotti
**15** De Bibuli edicto, nihil noui praeter illam exceptionem de qua tu ad me scripseras “nimis graui praeiudicio in ordinem nostrum”.	**15** Acerca do edito de Bíbulo, nada de novo além daquela exceção de que tu tinhas escrito a mim “um prejuízo bastante grave em nossa ordem”.	José Dejalma Dezotti
Ego tamen habeo ἰσοδυναμοῦσαν sed tectiorem ex Q. Muci P. f. edicto Asiatico, “extra quam si ita negotium gestum est ut eo stari non oporteat ex fide bona”;	Eu, contudo, tenho uma *com o mesmo valor*, mas mais dissimulada, procedente do edito asiático de Quinto Múcio, filho de Públio, “exceto se a transação tenha sido realizada de tal modo que não convém mantê-la de acordo com a boa fé”;	José Dejalma Dezotti
multaque sum secutus Scaeuolae, in iis illud in quo sibi libertatem censent Graeci datam, ut Graeci inter se disceptent suis legibus.	tenho seguido muitos preceitos de Cévola, entre esses aquele no qual os gregos consideram que lhes foi dada a liberdade para que os gregos decidam entre si de acordo com suas próprias leis.	José Dejalma Dezotti
Breue autem edictum est propter hanc meam διαίρεσιν, quod duobus generibus edicendum putaui;	O edito, porém, é curto devido a esta minha *divisão*, porque julguei que ele devia ser estabelecido em dois tipos:	José Dejalma Dezotti
quorum unum est prouinciale, in quo inest de rationibus ciuitatum, de aere alieno, de usura, de syngraphis, in eodem omnia de publicanis;	um desses tipos é o provincial, em que estão incluídas as contas das cidades, as dívidas, os juros, os contratos e no mesmo tudo a respeito dos publicanos;	José Dejalma Dezotti
alterum quod sine edicto satis commode transigi non potest, de hereditatum possessionibus, de bonis possidendis, magistris faciendis, bonis uendendis, quae ex edicto et postulari et fieri solent.	o outro, aquilo que nao pode ser levado a cabo suficientemente bem sem um edito, a possessão das heranças, a posse dos bens, a eleição dos síndicos, a venda dos bens, coisas que costumam ser demandadas e feitas a partir de um edito.	José Dejalma Dezotti
Tertium de reliquo iure dicundo ἄγραφον reliqui.	O terceiro, acerca do restante da administração da justiça, deixei *sem escrita*.	José Dejalma Dezotti
Dixi me de eo genere mea decreta ad edicta urbana accommodaturum, itaque curo et satis facio adhuc omnibus.	Eu disse que acomodaria meus decretos desse tipo aos editos urbanos, e assim cuido e satisfaço até agora a todo mundo.	José Dejalma Dezotti
Graeci uero exsultant quod peregrinis iudicibus utuntur.	Os gregos, na verdade, estão exultantes porque se utilizam de juízes estrangeiros.	José Dejalma Dezotti
“Nugatoribus quidem” inquies.	“Charlatães, na verdade” dirás.	José Dejalma Dezotti
Quid refert?	O que importa?	José Dejalma Dezotti
Ii se αὐτονομίαν adeptos putant.	Eles consideram que adquiriram *autonomia*.	José Dejalma Dezotti
Nostri enim, credo, grauis habent, Turpionem sutorium et Vettium mancipem.	Pois os nossos, creio, têm gente séria, o sapateiro Turpião e o empresário Vétio.	José Dejalma Dezotti
**16** De publicanis quid agam uideris quaerere.	**16** Parece que queres saber o que faço a respeito dos publicanos.	José Dejalma Dezotti
Habeo in deliciis, obsequor, uerbis laudo, orno:	Tenho-os em bem-querença, condescendo com eles, louvo-os e adorno com palavras:	José Dejalma Dezotti
efficio ne cui molesti sint.	consigo que não sejam molestos a ninguém.	José Dejalma Dezotti
τὸ παραδοξότατον:	*O mais surpreendente:*	José Dejalma Dezotti
usuras eorum quas pactionibus adscripserant seruauit etiam Seruilius;	os juros que eles tinham especificados nos contratos até Servílio manteve;	José Dejalma Dezotti
ego sic: diem statuo satis laxam, quam ante si soluerint, dico me centesimas ducturum, si non soluerint, ex pactione.	eu assim: estabeleço um prazo bastante amplo, se pagarem antes desse, digo que considerarei um por cento ao mês; se não pagarem, será de acordo com o contrato.	José Dejalma Dezotti
Itaque et Graeci soluunt tolerabili faenore et publicanis res est gratissima, si illa iam habent pleno modio, uerborum honorem, inuitationem crebram.	E assim os gregos pagam um juro tolerável e para os publicanos a situação é muito boa, pois já têm aquelas coisas com plena medida, a honra das palavras e frequente convite.	José Dejalma Dezotti
Quid plura?	O que mais?	José Dejalma Dezotti
Sunt omnes ita mihi familiares ut se quisque maxime putet;	São todos tão amigos meus que cada um se considera o maior;	José Dejalma Dezotti
sed tamen “μηδὲν αὐτοῖς” \- scis reliqua.	mas “*nada os...*” sabes o resto.	José Dejalma Dezotti
**17** De statua Africani (ὢ πραγμάτων ἀσυγκλώστων\! sed me id ipsum delectauit in tuis litteris), ain tu?	**17** Com relação à estátua do Africano (*ó assuntos mais desconexos\!* mas é precisamente isso que me deliciou em tua carta), o que tu dizes?	José Dejalma Dezotti
Scipio hic Metellus proauum suum nescit censorem non fuisse?	Este Cipião Metelo não sabe que seu bisavô não foi censor?	José Dejalma Dezotti
Atqui nihil habuit aliud inscriptum nisi “cos.” ea statua quae ab Opis parte postica in excelso est.	E essa estátua, que está no alto perto da parte posterior do templo de Ops não teve nada mais inscrito a não ser “cos.”	José Dejalma Dezotti
In illa autem quae est ad Πολυκλέους Herculem inscriptum est “cos. Cens.”;	Porém, naquela que está junto ao Hércules de Policles está inscrito “cos. Cens.”;	José Dejalma Dezotti
quam esse eiusdem status, amictus, anulus, imago ipsa declarat.	e que essa estátua é do mesmo a estatura, o manto, o anel, a própria imagem indicam.	José Dejalma Dezotti
At mehercule ego, cum in turma inauratarum equestrium quas hic Metellus in Capitolio posuit animaduertissem in Sarapionis subscriptione Africani imaginem, erratum fabrile putaui, nunc uideo Metelli.	Mas, por hércules, eu, quando notei no esquadrão das estátuas equestres douradas que este Metelo pôs no Capitólio uma imagem do Africano com o nome de Sarapião escrito embaixo, achei que era erro do operário, agora vejo que é de Metelo.	José Dejalma Dezotti
o ἀνιστορησίαν turpem\!	Ó vergonhoso *erro histórico*\!	José Dejalma Dezotti
**18** Nam illud de Flauio et fastis, si secus est, commune erratum est;	**18** Pois o de Flávio e dos fastos, se é de outro modo, é um erro comum;	José Dejalma Dezotti
et tu belle ἠπόρησας et nos publicam prope opinionem secuti sumus, ut multa apud Graecos.	e tu *estavas* lindamente *em dúvida* e nós mais ou menos seguimos a opinião pública, como muitas coisas entre os gregos.	José Dejalma Dezotti
Quis enim non dixit Εὔπολιν τὸν τῆς ἀρχαίας ab Alcibiade nauigante in Siciliam deiectum esse in mare?	Pois quem não disse que *Eupólis, o da comédia antiga*, foi atirado ao mar por Alcibíades, quando navegava para a Sicília?	José Dejalma Dezotti
Redarguit Eratosthenes;	Eratóstenes refuta isso;	José Dejalma Dezotti
adfert enim quas ille post id tempus fabulas docuerit.	pois apresenta as comédias que ele representou depois daquela data.	José Dejalma Dezotti
Num idcirco Duris Samius, homo in historia diligens, quod cum multis errauit, irridetur?	Por acaso Dúris de Samos, homem diligente em História, é objeto de riso por que errou junto com muitos?	José Dejalma Dezotti
Quis Zaleucum leges Locris scripsisse non dixit?	Quem não disse que Zaleuco escreveu as leis de Locros?	José Dejalma Dezotti
Num igitur iacet Theophrastus si id a Timaeo, tuo familiari, reprehensum est?	Por acaso Teofrasto está então abatido por isso ter sido repreendido por Timeu, teu amigo?	José Dejalma Dezotti
Sed nescire proauum suum censorem non fuisse turpe est, praesertim cum post eum consulem nemo Cornelius illo uiuo censor fuerit.	Mas é vergonhoso não saber que seu próprio bisavô não foi censor, sobretudo quando, após ter sido ele cônsul, não houve nenhum Cornélio censor, enquanto ele esteve vivo.	José Dejalma Dezotti
**19** Quod de Philotimo et de solutione HS XXDC scribis, Philotimum circiter Kal. Ian. in Chersonesum audio uenisse;	**19** Quanto ao que escreves sobre Filótimo e sobre o pagamento de 20.600 sestércios, ouço que Filótimo chegou em Quersoneso por volta da calendas de janeiro \[1º. de janeiro\];	José Dejalma Dezotti
At mi ab eo nihil adhuc.	Mas a mim nada da parte dele até agora.	José Dejalma Dezotti
Reliqua mea Camillus scribit se accepisse.	Camilo escreve que recebeu o meu restante.	José Dejalma Dezotti
Ea quae sint nescio et aueo scire.	Não sei o que é e tenho vontade de saber.	José Dejalma Dezotti
Sed uerum haec posterius et coram fortasse commodius.	Mas, na verdade, isso talvez melhor mais tarde e pessoalmente.	José Dejalma Dezotti
**20** Illud me, mi Attice, in extrema fere parte epistulae commouit;	**20** Aquilo quase na parte final da carta, meu querido Ático, me abalou;	José Dejalma Dezotti
scribis enim sic, “τί λοιπόν;”, deinde me obsecras amantissime ne obliuiscar uigilare et ut animaduertam quae fiant.	pois escreves assim, “*o que resta, então?*”, depois me suplicas muito carinhosamente que eu não me esqueça de estar alerta e que preste atenção ao que acontece.	José Dejalma Dezotti
Num quid de quo inaudisti?	O que é que ouviste e a respeito de quem?	José Dejalma Dezotti
Etsi nihil eius modi est;	Ainda que não haja nada desse tipo;	José Dejalma Dezotti
πολλοῦ γε καὶ δεῖ.		José Dejalma Dezotti
Nec enim me fefellisset nec fallet.	Pois nem me teria escapado nem me escapará.	José Dejalma Dezotti
Sed ista admonitio tua tam accurata nescio quid mihi significare uisa est.	Mas essa advertência tua tão cuidadosa me pareceu indicar não sei o que.	José Dejalma Dezotti
**21** De M. Octauio, iterum iam tibi rescribo te illi probe respondisse;	**21** A respeito de Marco Otávio, te repito novamente que tu já respondeste corretamente a ele;	José Dejalma Dezotti
paulo uellem fidentius.	eu queria com um pouco mais de firmeza.	José Dejalma Dezotti
Nam Caelius libertum ad me misit et litteras accurate scriptas et de pantheris et (+) a ciuitatibus.	Pois Célio me mandou um liberto e uma carta cuidadosamente escrita sobre as panteras e (+) das cidades.	José Dejalma Dezotti
Rescripsi ad alterum me moleste ferre, si ego in tenebris laterem nec audiretur Romae nullum in mea prouincia nummum nisi in aes alienum erogari, docuique nec mihi conciliare pecuniam licere nec illi capere, monuique eum, quem plane diligo, ut cum alios accusasset cautius uiueret;	Respondi ao segundo que me sinto mal, se eu me oculto em trevas e não se ouve em Roma que não foi fornecido para as despesas em minha província nenhuma moeda a não ser para as dívidas, e mostrei que nem a mim era permitido conseguir dinheiro nem a ele recebê-lo, e adverti a ele, a quem tenho grande apreço, que, visto que tinha acusado os outros, vivesse com mais cautela;	José Dejalma Dezotti
illud autem alterum alienum esse existimatione mea, Cibyratas imperio meo publice uenari.	já o outro ponto, que era incompatível com minha reputação que os habitantes de Cíbira caçassem oficialmente por ordem minha.	José Dejalma Dezotti
**22** Lepta tua epistula gaudio exsultat;	**22** Lepta está pulando de alegria com tua carta;	José Dejalma Dezotti
etenim scripta belle est meque apud eum magna in gratia posuit.	de fato, está magnificamente escrita e me pôs em grande disposição junto a ele.	José Dejalma Dezotti
Filiola tua gratum mihi fecit quod tibi diligenter mandauit ut mihi salutem adscriberes, gratum etiam Pilia, sed illa officiosius quod me, quem iam pridem amat, numquam uidit;	Tua filhinha me fez agradecido por ter te encarregado com diligência que me saudasses, agradecido também a Pília, mas aquela mais atenciosamente porque a mim, que já há muito me quer bem, nunca me viu;	José Dejalma Dezotti
igitur tu quoque salutem utrique adscribito.	portanto, tu também saúde a ambas.	José Dejalma Dezotti
Litterarum datarum dies prid. Kal. Ian. suauem habuit recordationem clarissimi iuris iurandi quod ego non eram oblitus;	O dia da entrega de tua carta, véspera das calendas de janeiro \[31 de dezembro\] teve uma doce lembrança do famosíssimo juramento que eu não esqueci;	José Dejalma Dezotti
Magnus enim praetextatus illo die fui.	pois fui Magno aquele dia com a toga pretexta.	José Dejalma Dezotti
Habes ad omnia;	Tens tudo;	José Dejalma Dezotti
non, ut postulasti, “χρύσεα χαλκείων” sed paria paribus respondimus.	não, como pediste, “ouro por bronze”, mas respondemos ponto por ponto.	José Dejalma Dezotti
**23** Ecce autem alia pusilla epistula, quam non relinquam ἀναντιφώνητον.	**23** Eis, porém, outra pequena carta, que não deixarei *sem resposta*.	José Dejalma Dezotti
Bene mehercule proposuit Lucceius Tusculanum, nisi forte (solet enim) cum suo tibicine;	Com acerto, por hércules, Luceio pôs à venda sua chácara em Túsculo, a não ser que talvez (como costuma) com seu próprio flautista.	José Dejalma Dezotti
et uelim scire qui sit eius status.	e eu queria saber qual é a situação dele.	José Dejalma Dezotti
Lentulum quidem nostrum \*\*\* praeter Tusculanum proscripsisse audio.	Ouço, na verdade, que o nosso amigo Lêntulo pôs \[tudo\] à venda, exceto a chácara de Túsculo.	José Dejalma Dezotti
Cupio hos expeditos uidere, cupio etiam Sestium, adde sis Caelium;	Desejo vê-los desembaraçados, desejo também a Séstio, acrescenta, se queres, Célio;	José Dejalma Dezotti
in quibus omnibus est “αἴδεσθεν μὲν ἀνήνασθαι, δεῖσαν δ' ὑποδέχθαι”.	em todos esses há “*vergonha em recusar, temor em aceitar*”.	José Dejalma Dezotti
De Memmio restituendo ut Curio cogitet te audisse puto.	Sobre a restituição de Mêmio acho que ouviste como Curião pensa fazê-lo.	José Dejalma Dezotti
De Egnati Sidicini nomine nec nulla nec magna spe sumus.	Sobre a dívida de Egnácio Sidicino estamo com alguma, não grande esperança.	José Dejalma Dezotti
Pinarium, quem mihi commendas, diligentissime Deiotarus curat grauiter aegrum.	A Pinário, que me recomendas, gravemente doente, Dejótaro cuida dele com o maior empenho.	José Dejalma Dezotti
Respondi etiam minori.	Respondi também a mais curta.	José Dejalma Dezotti
**24** Tu uelim dum ero Laodiceae, id est ad Id. Mai., quam saepissime mecum per litteras colloquare et cum Athenas ueneris (iam enim sciemus de rebus urbanis, de prouinciis, quae omnia in mensem Martium sunt collata) utique ad me tabellarios mittas.	**24** Queria que tu, enquanto eu estiver em Laodicéia, isto é, até os idos de maio \[15 de maio\] falasse comigo por cartas o mais frequentemente possível e, quando vieres a Atenas (pois já saberemos sobre os assuntos urbanos, sobre as províncias, tudo que foi aprazado para o mês de março), me envies sobretudo carteiros.	José Dejalma Dezotti
**25** Et heus tu, †genua† uos a Caesare per Herodem talenta Attica L extorsistis?	**25** E olha tu, vós arrancastes de César por intermédio de Herodes cinquenta talentos áticos?	José Dejalma Dezotti
In quo, ut audio, magnum odium Pompei suscepistis;	Com isso, conforme ouço, atraístes um grande ódio de Pompeu;	José Dejalma Dezotti
putat enim suos nummos uos comedisse, Caesarem in Nemore aedificando diligentiorem fore.	pois ele acha que vós comestes o seu próprio dinheiro, que César será mais diligente em edificar no Bosque.	José Dejalma Dezotti
Haec ego ex P. Vedio, magno nebulone sed Pompei tamen familiari, audiui.	Essas coisas eu ouvi de Públio Védio, um grande patife, mas amigo íntimo de Pompeu.	José Dejalma Dezotti
Hic Vedius mihi obuiam uenit cum duobus essedis et raeda equis iuncta et lectica et familia magna, pro qua, si Curio legem pertulerit, HS centenos pendat necesse est;	Este Védio veio ao meu encontro com duas carruagens e um carro com cavalos atrelados e uma liteira e uma grande séquito de escravos, pelo qual, se Curião fizer aprovar sua lei, é necessário que pague cem sestércios por cada um;	José Dejalma Dezotti
erat praeterea cynocephalus in essedo nec deerant onagri.	havia, além disso, um macaco na carruagem e não faltavam burros selvagens.	José Dejalma Dezotti
Numquam uidi hominem nequiorem.	Nunca vi um homem mais sem valor.	José Dejalma Dezotti
Sed extremum audi.	Mas escuta o final.	José Dejalma Dezotti
Deuersatus est Laodiceae apud Pompeium Vindillum;	Em Laodicéia, ele se hospedou na casa de Pompeu Vindilo;	José Dejalma Dezotti
ibi sua deposuit cum ad me profectus est.	ali deixou suas coisas quando veio até mim.	José Dejalma Dezotti
Moritur interim Vindillus.	Nesse ínterim, morre Vindilo.	José Dejalma Dezotti
Quod res ad Magnum Pompeium pertinere putabatur, C. Vennonius domum Vindilli uenit.	Como se pensava que coisas dele pertenciam a Pompeu Magno, Caio Venônio veio à casa de Vindilo.	José Dejalma Dezotti
Cum omnia obsignaret, in Vedianas res incidit.	Quando punha o selo em tudo, deu com as coisas de Védio.	José Dejalma Dezotti
In his inuentae sunt quinque imagunculae matronarum, in quibus una sororis amici tui, hominis bruti qui hoc utatur, et uxoris illius lepidi qui haec tam neglegenter ferat.	Nestas, foram encontradas cinco pequenos bustos de matronas, nos quais um da irmã de teu amigo, um homem bruto, que se vale deste nome, e o da esposa daquele lépido que leva isso tão negligentemente.	José Dejalma Dezotti
Haec te uolui παριστορῆσαι;	Quis te *contar* isso;	José Dejalma Dezotti
sumus enim ambo belle curiosi.	pois somos ambos lindamente curiosos.	José Dejalma Dezotti
**26** Vnum etiam uelim cogites.	**26** Eu queria ainda que meditasses uma coisa.	José Dejalma Dezotti
Audio Appium πρόπυλον Eleusine facere;	Ouço que Ápio está fazendo um *pórtico* em Elêusis;	José Dejalma Dezotti
num inepti fuerimus si nos quoque Academiae fecerimus?	acaso seremos idiotas, se nós fizermos um na Academia?	José Dejalma Dezotti
“Puto” inquies.	“Acho” dirás.	José Dejalma Dezotti
Ergo id ipsum scribes ad me.	Então escreves isso mesmo a mim.	José Dejalma Dezotti
Equidem ualde ipsas Athenas amo;	Na verdade, eu amo demais a própria Atenas;	José Dejalma Dezotti
uolo esse aliquod monumentum, odi falsas inscriptiones statuarum alienarum.	quero ser algum monumento, odeio as falsas inscrições das estátuas alheias.	José Dejalma Dezotti
Sed ut tibi placebit, faciesque me in quem diem Romana incidant mysteria certiorem et quo modo hiemaris.	Mas, se te agradar, me informarás em que dia caem os mistérios romanos e como estás passando o inverno.	José Dejalma Dezotti
Cura ut ualeas.	Cuida para que estejas bem de saúde.	José Dejalma Dezotti
Post Leuctricam pugnam die septingentesimo sexagesimo quinto.	No septingentésimo sexagésimo quinto dia após a batalha de Leuctra.	José Dejalma Dezotti
		José Dejalma Dezotti
**2**	**2**	José Dejalma Dezotti
Cicero Attico sal.	Cícero saúda Ático.	José Dejalma Dezotti
**1** Cum Philogenes, libertus tuus, Laodiceam ad me salutandi causa uenisset et se statim ad te nauigaturum esse diceret, has ei litteras dedi, quibus ad eas rescripsi quas acceperam a Bruti tabellario.	**1** Como Filógenes, teu liberto, tivesse vindo até mim em Laodicéia para me saudar e dissesse que logo embarcaria para junto de ti, entreguei-lhe esta carta, na qual respondi àquela que eu tinha recebido do carteiro de Bruto.	José Dejalma Dezotti
Et respondebo primum postremae tuae paginae, qua mihi magnae molestiae fuit quod ad te scriptum est a Cincio de Stati sermone;	E vou responder primeiramente a tua última página, na qual foi de grande preocupação para mim o que foi escrito para ti por Cíncio acerca da conversa de Estácio;	José Dejalma Dezotti
in quo hoc molestissimum est, Statium dicere a me quoque id consilium probari.	o mais preocupante nesta é Estácio dizer que esse plano é aprovado também por mim.	José Dejalma Dezotti
Ego autem de isto hactenus dixerim, me uel plurima uincla tecum summae coniunctionis optare, etsi sunt amoris artissima;	Eu, porém, sobre isso diria apenas que desejo o maior número de laços possível da mais íntima ligação contigo, ainda que sejam estreitíssimos os de nossa afeição;	José Dejalma Dezotti
tantum abest ut ego ex eo quo astricti sumus laxari aliquid uelim.	está muito longe para que eu queira afrouxar alguma coisa disso com que somos unidos.	José Dejalma Dezotti
**2** Illum autem multa de istis rebus asperius solere loqui saepe sum expertus, saepe etiam leniui iratum;	**2** Que ele, por outro lado, costuma falar muito sobre essas coisas com demasiada aspereza frequentemente experimentei, frequentemente também abrandei-o em sua ira;	José Dejalma Dezotti
id scire te arbitror.	julgo que tu sabes isso.	José Dejalma Dezotti
In hac autem peregrinatione militiaue nostra saepe incensum ira uidi, saepe placatum.	Já nesta viagem ao exterior, ou melhor, em nossa campanha militar, muitas vezes o vi inflamado de ira, muitas vezes acalmado.	José Dejalma Dezotti
Quid ad Statium scripserit nescio;	O que ele escreveu para Estácio não sei;	José Dejalma Dezotti
quicquid acturus de tali re fuit, scribendum tamen ad libertum non fuit.	o que quer que iria fazer acerca de tal assunto não deve ter, contudo, escrito a um liberto.	José Dejalma Dezotti
Mihi autem erit maximae curae ne quid fiat secus quam uolumus quamque oportet.	Eu terei, porém, o maior cuidado para que nada aconteça diferentemente do que queremos e do que convém.	José Dejalma Dezotti
Nec satis est in eius modi re se quemque praestare, ac maximae partes istius offici sunt pueri Ciceronis siue iam adulescentis;	E num caso desse tipo não é suficiente que cada um se mostre responsável, e as maiores partes desse dever são do menino Cícero ou já um jovem;	José Dejalma Dezotti
quod quidem illum soleo hortari.	porque, na verdade, costumo exortá-lo.	José Dejalma Dezotti
Ac mihi uidetur ualde matrem, ut debet, amare teque mirifice;	E a mim me parece que ele ama muito a sua mãe, como deve, e magnificamente a ti;	José Dejalma Dezotti
sed est magnum illud quidem uerum tamen multiplex pueri ingenium;	mas, na verdade, é grande o caráter do garoto, contudo complexo;	José Dejalma Dezotti
quod ego regendo habeo negoti satis.	eu tenho um demasiado trabalho de conduzi-lo.	José Dejalma Dezotti
**3** Quoniam respondi postremae tuae paginae prima mea, nunc ad primam reuertar tuam.	**3** Visto que respondi a tua última página na primeira minha, agora voltarei para a primeira tua.	José Dejalma Dezotti
Peloponnesias ciuitates omnis maritimas esse hominis non nequam sed etiam tuo iudicio probati, Dicaearchi tabulis credidi.	Acreditei, pelos mapas de Dicearco, um homem não inútil, mas ainda aprovado pelo teu juízo, que todas as cidades do Peloponeso são marítimas.	José Dejalma Dezotti
Is multis nominibus in Trophoniana Chaeronis narratione Graecos in eo reprehendit quod maritima secuti sint, nec ullum in Peloponneso locum excipit.	Ele, em muitos pontos, no relato de Querão sobre Trofônio, repreende os gregos no fato de ter buscado o mar e não excetua um único lugar no Peloponeso.	José Dejalma Dezotti
Cum mihi auctor placeret (etenim erat ἱστορικώτατος et uixerat in Peloponneso), admirabar tamen et uix adcredens communicaui cum Dionysio.	Ainda que esse autor fosse do meu agrado (pois era *um ótimo historiador* e tinha vivido no Peloponeso), eu achava estranho, contudo, e, mal acreditando nele, me comuniquei com Dionísio.	José Dejalma Dezotti
Atque is primo est commotus, deinde, quod de isto Dicaearcheo non minus bene existimabat quam tu de C. Vestorio, ego de M. Cluuio, non dubitabat quin ei crederemus.	E este, em princípio, se sobressaltou, depois, uma vez que tinha acerca desse Dicearco uma opinião não menos boa do que tu de Caio Vestório, eu, de Marco Clúvio, não hesita em acreditarmos nele.	José Dejalma Dezotti
Arcadiae censebat esse Lepreon quoddam maritimum;	Pensa que na Arcádia há um Lépreo marítimo;	José Dejalma Dezotti
Tenea autem et Aliphera et Tritia νεόκτιστα ei uidebantur, idque τῷ τῶν νεῶν καταλόγῳ confirmabat, ubi mentio non fit istorum.	Já Tênea e Alífera e Trítia lhe pareciam *fundações recentes*, e confirmava isso com o catálogo das naus, onde não ocorre menção a elas.	José Dejalma Dezotti
Itaque istum ego locum totidem uerbis a Dicaearcho transtuli.	E assim eu traduzi palavra por palavra toda essa passagem de Dicearco.	José Dejalma Dezotti
“Phliasios” autem dici sciebam et ita fac ut habeas;	Por outro lado sei que se diz “Fliásios” e faz assim para que tenhas;	José Dejalma Dezotti
nos quidem sic habemus.	nós, na verdade, já temos assim.	José Dejalma Dezotti
Sed primo me ἀναλογία deceperat, Φλιοῦς, ᾿Οποῦς, Σιποῦς, quod ᾿Οπούντιοι, Σιπούντιοι;	Mas, no início, tinha me confundido *a analogia* de *Fliunte, Opunte, Sipunte*, pelo de *Opúntios, Sipúntios*;	José Dejalma Dezotti
sed hoc continuo correximus.	mas logo em seguida corrigimos isso.	José Dejalma Dezotti
**4** Laetari te nostra moderatione et continentia uideo.	**4** Vejo que te alegras com minha moderação e comedimento.	José Dejalma Dezotti
Tum id magis faceres, si adesses.	Farias mais, se estivesses aqui.	José Dejalma Dezotti
Atque hoc foro quod egi ex Id. Febr. Laodiceae ad Kal. Mai. omnium dioecesium praeter Ciliciae mirabilia quaedam effecimus;	E nessa sessão do tribunal que realizei em Laodicéia dos idos de fevereiro \[13 de fevereiro\] até as calendas de maio \[1º. de maio\] para todos os distritos, exceto o da Cilícia, fiz coisas maravilhosas;	José Dejalma Dezotti
ita multae ciuitates omni aere alieno liberatae, multae ualde leuatae sunt, omnes suis legibus et iudiciis usae αὐτονομίαν adeptae reuixerunt.	assim muitas cidades foram livradas de toda dívida, muitas foram bastante aliviadas, todas, tendo adquirido sua *autonomia* e usado suas próprias leis e tribunais, reviveram.	José Dejalma Dezotti
His ego duobus generibus facultatem ad se aere alieno liberandas aut leuandas dedi:	Eu lhes dei a possibilidade de livrar-se de suas dívidas ou de aliviá-las por estes dois procedimentos:	José Dejalma Dezotti
uno quod omnino nullus in imperio meo sumptus factus est;	um porque não se fez em meu governo absolutamente nenhum gasto;	José Dejalma Dezotti
nullum cum dico non loquor ὑπερβολικῶς:	quando digo nenhum não falo *em hipérbole*:	José Dejalma Dezotti
nullus inquam, ne terruncius quidem.	nenhum, digo, nem sequer a quarta parte de um as.	José Dejalma Dezotti
Hac autem re incredibile est quantum ciuitates emerserint.	É incrível o quanto as cidades ressurgiram com este procedimento.	José Dejalma Dezotti
**5** Accessit altera:	**5** Acrescente-se o outro:	José Dejalma Dezotti
mira erant in ciuitatibus ipsorum furta Graecorum quae magistratus sui fecerant.	eram surpreendentes os roubos dos próprios gregos nas cidades que seus próprios magistrados tinham feito.	José Dejalma Dezotti
Quaesiui ipse de iis qui annis decem proximis magistratum gesserant;	Eu próprio perguntei aos que tinham desempenhado a magistratura nos últimos dez anos;	José Dejalma Dezotti
aperte fatebantur.	confessavam abertamente.	José Dejalma Dezotti
Itaque sine ulla ignominia suis umeris pecunias populis rettulerunt.	E assim, sem nenhuma desonra, restituíram o dinheiro ao povo a suas proprias custas.	José Dejalma Dezotti
Populi autem nullo gemitu publicanis, quibus hoc ipso lustro nihil soluerant, etiam superioris lustri reddiderunt;	O povo, por sua vez, sem nenhum gemido, devolveram aos publicanos, para os quais neste lustro não tinham pagado nada, e mesmo do lustro anterior;	José Dejalma Dezotti
itaque publicanis in oculis sumus.	e assim somos a menina-dos-olhos dos publicanos.	José Dejalma Dezotti
“Gratis” inquis “uiris.”	“Homens agradecidos”, dizes.	José Dejalma Dezotti
Sensimus.	Notamos.	José Dejalma Dezotti
Iam cetera iuris dictio nec imperita et clemens cum admirabili facilitate.	Já o resto de minha atuação judicial, não inábil, e clemente, com uma admirável facilidade.	José Dejalma Dezotti
Aditus autem ad me minime prouinciales.	Os acessos a mim nem um pouco provinciais.	José Dejalma Dezotti
Nihil per cubicularium;	Nada por meio de um criado de quarto;	José Dejalma Dezotti
ante lucem inambulabam domi ut olim candidatus.	antes do amanhecer, passeio em casa como outrora, quando candidato.	José Dejalma Dezotti
Grata haec et magna mihique nondum laboriosa ex illa uetere militia.	Isto é popular e grande e ainda não laborioso para mim graças àquela minha antiga vida militar.	José Dejalma Dezotti
**6** Non. Mai. in Ciliciam cogitabam;	**6** Nas nonas de maio \[7 de maio\] penso em ir para Cilícia.	José Dejalma Dezotti
ibi cum Iunium mensem consumpsissem (atque utinam in pace\! magnum enim bellum impendet a Parthis), Quintilem in reditu ponere.	depois de passar ali o mês de junho (e tomara que em paz\! pois ameaça uma grande guerra da parte dos partos), estaelecer julho para meu retorno.	José Dejalma Dezotti
Annuae enim mihi operae a. d. III Kal. Sext. emerentur.	Pois meus serviços anuais se cumprem no terceiro dia antes das calendas de agosto \[30 de julho\]	José Dejalma Dezotti
Magna autem in spe sum mihi nihil temporis prorogatum iri.	Estou com grande esperança de que não se prorrogará nenhum minuto.	José Dejalma Dezotti
Habebam acta urbana usque ad Non. Mart.;	Tenho as atas da cidade até as nonas de março \[7 de março\];	José Dejalma Dezotti
e quibus intellegebam Curionis nostri constantia omnia potius actum iri quam de prouinciis.	destas eu entendo que a firmeza de nosso amigo Curião tratará de tudo antes do que o que diz respeito às províncias.	José Dejalma Dezotti
Ergo, ut spero, prope diem te uidebo.	Portanto, conforme espero, te verei dentro de pouco tempo.	José Dejalma Dezotti
**7** Venio ad Brutum tuum, immo nostrum (sic enim mauis).	**7** Passo ao teu querido Bruto, ou melhor, ao nosso (pois preferes assim).	José Dejalma Dezotti
Equidem omnia feci quae potui aut in mea prouincia perficere aut in regno experiri.	Na verdade fiz tudo o que pude realizar em minha província ou tentar no reino.	José Dejalma Dezotti
Omni igitur modo egi cum rege et ago cottidie, per litteras scilicet;	Portanto, por todos os meios tratei e trato diariamente com o rei, por meio de cartas evidentemente;	José Dejalma Dezotti
ipsum enim triduum quadriduumue mecum habui turbulentis in rebus quibus eum liberaui.	pois tive-o comigo três ou quatro dias em meio àqueles casos turbulentos dos quais o livrei.	José Dejalma Dezotti
Sed et tum praesens et postea creberrimis litteris non destiti rogare et petere mea causa, suadere et hortari sua.	Mas então pessoalmente e posteriormente por cartas frequentíssimas não deixei de rogar-lhe e pedir-lhe em meu interesse, de persuadi-lo e aconselhá-lo no seu.	José Dejalma Dezotti
Multum profeci, sed quantum, non plane, quia longe absum, scio.	Muito consegui, mas quanto não sei bem, porque estou longe.	José Dejalma Dezotti
Salaminos autem (hos enim poteram coercere) adduxi ut totum nomen Scaptio uellent soluere, sed centesimis ductis a proxima quidem syngrapha nec perpetuis sed renouatis quotannis.	Por outro lado, convenci os salaminos (pois eu podia obrigá-los) a que quisessem pagar toda a sua dívida a Escápcio, mas a um por cento mensal a partir do último contrato e não simples, mas composto por anos.	José Dejalma Dezotti
Numerabantur nummi:	Contava-se o dinheiro:	José Dejalma Dezotti
noluit Scaptius.	Escápcio não aceitou.	José Dejalma Dezotti
Quid tu, qui ais Brutum cupere aliquid perdere?	E tu, que dizes que Bruto deseja ter alguma perda?	José Dejalma Dezotti
“Quaternas habebat in syngrapha”.	“Tinha no contrato quatro por cento mensal”.	José Dejalma Dezotti
Fieri non poterat nec, si posset, ego pati possem.	Não podia ser, nem, se pudesse, eu podia admitir.	José Dejalma Dezotti
Audio omnino Scaptium paenitere.	Ouço que Escápcio está completamente arrependido.	José Dejalma Dezotti
Nam quod senatus consultum esse dicebat ut ius ex syngrapha diceretur, eo consilio factum est quod pecuniam Salamini contra legem Gabiniam sumpserant.	Pois quanto ao que ele dizia que um decreto do senado ordenava que a decisão fosse de acordo com o contrato, por essa razão ocorreu que os Salaminos tinham tomado dinheiro emprestado contra a lei Gabínia.	José Dejalma Dezotti
Vetabat autem ea lex ius dici de ita sumpta pecunia;	Essa lei proibia que se pronunciasse uma decisão sobre um dinheiro emprestado desse modo;	José Dejalma Dezotti
decreuit igitur senatus ut ius diceretur ex ista syngrapha.	portanto, o senado decretou que se pronunciasse a decisão de acordo com esse contrato.	José Dejalma Dezotti
Nunc ista habet iuris idem quod ceterae, nihil praecipui.	Agora esse tem a mesma validade jurídica que os outros, nada de privilégio.	José Dejalma Dezotti
**8** Haec a me ordine facta puto me Bruto probaturum, tibi nescio, Catoni certe probabo.	**8** Acho que terei a aprovação de Bruto nessas coisas feitas devidamente por mim, a ti não sei, de Catão com certeza terei a aprovação.	José Dejalma Dezotti
Sed iam ad te ipsum reuertor.	Mas agora volto a ti.	José Dejalma Dezotti
Ain tandem, Attice, laudator integritatis et elegantiae nostrae?	Dizes realmente, Ático, tu, elogiador de nossa integridade e correção?	José Dejalma Dezotti
“Ausus es hoc ex ore tuo” (inquit Ennius), ut equites Scaptio ad pecuniam cogendam darem me rogare?	“Ousaste com tua própria boca” (diz Ênio), pedir-me que desse a Escápcio a cavalaria para recobrar o teu dinheiro?	José Dejalma Dezotti
An tu si mecum esses, qui scribis morderi te interdum quod non simul sis, paterere me id facere si uellem?	Por acaso se tu estivesses comigo, tu, que escreves que te irritas por não estar a meu lado, permitirias que eu fizesse isso, se eu quisesse?	José Dejalma Dezotti
“Non amplius” inquis “quinquaginta.”	“Não mais que cinquenta” dizes.	José Dejalma Dezotti
Cum Spartaco minus multi primo fuerunt.	Com Espártaco, no princípio, estiveram muitos menos.	José Dejalma Dezotti
Quid tandem isti mali in tam tenera insula non fecissent?	O que não teriam feito esses malévolos em uma ilha tão frágil?	José Dejalma Dezotti
Non fecissent autem?	Não teriam feito?	José Dejalma Dezotti
Immo quid ante aduentum meum non fecerunt?	Mas e o que não fizeram antes de minha chegada?	José Dejalma Dezotti
Inclusum in curia senatum habuerunt Salaminum ita multos dies ut interierint non nulli fame;	Mantiveram o senado dos salaminos fechado dentro da cúria durante tão numerosos dias que alguns morreram de fome;	José Dejalma Dezotti
erat enim praefectus Appi Scaptius et habebat turmas ab Appio.	pois Escápcio era prefeito de Ápio e tinha pelotões de Ápio.	José Dejalma Dezotti
Id me igitur tu, cuius mehercule os mihi ante oculos solet uersari cum de aliquo officio ac laude cogito, tu me, inquam, rogas praefectus ut Scaptius sit?	Então tu, cujo rosto, por hércules, costuma apresentar-se diante de meus olhos quando penso em algum dever ou louvor, tu, eu digo, me pedes que Escápcio seja prefeito?	José Dejalma Dezotti
At hoc statueramus, ut negotiatorem neminem, idque Bruto probamus.	Mas tínhamos estabelecido isso, que nenhum comerciante e nisso temos a aprovação de Bruto.	José Dejalma Dezotti
Habeat is turmas?	Que ele tenha pelotões?	José Dejalma Dezotti
Cur potius quam cohortis?	Por que é melhor do que coortes?	José Dejalma Dezotti
**9** Sumptu iam nepos euadit Scaptius.	**9** Com a despesa Escápcio já se torna um dissipador.	José Dejalma Dezotti
“Volunt” inquit “principes.”	“Os chefes querem” ele diz.	José Dejalma Dezotti
Scio; nam ad me Ephesum usque uenerunt flentesque equitum scelera et miserias suas detulerunt.	Sei; pois vieram ao meu encontro em Éfeso e, chorando, denunciaram os crimes dos cavaleiros e suas próprias desgraças.	José Dejalma Dezotti
Itaque statim dedi litteras ut ex Cypro equites ante certam diem decederent, ob eamque causam tum ob ceteras Salamini nos in caelum decretis suis sustulerunt.	E assim entreguei imediatamente uma carta para os cavaleiros saíssem de Chipre antes deu dia determinado e, por esse motivo e por outros, os salaminos nos ergueram ao céu em seus decretos.	José Dejalma Dezotti
Sed iam quid opus equitatu?	Mas agora que necessidade há de cavalaria?	José Dejalma Dezotti
Soluunt enim Salamini;	Pois os salaminos pagam;	José Dejalma Dezotti
nisi forte id uolumus armis efficere, ut faenus quaternis centesimis ducant.	a não ser que por acaso queiramos conseguir isto pelas armas, que considerem um juro de quatro por cento.	José Dejalma Dezotti
Et ego audebo legere umquam aut attingere eos libros quos tu dilaudas, si tale quid fecero?	E eu vou me atrever a ler alguma vez ou tocar esses livros que tu louvas muitíssimo, se eu fizer algo semelhante?	José Dejalma Dezotti
Nimis, nimis, inquam, in isto Brutum amasti, dulcissime Attice, nos uereor ne parum.	Demais, demais, eu digo, amaste Bruto nisso, ó dulcíssimo Ático, a mim receio que pouco.	José Dejalma Dezotti
Atque haec scripsi ego ad Brutum scripsisse te ad me.	E eu escrevi a Bruto que tu tinhas escrito isto a mim.	José Dejalma Dezotti
**10** Cognosce nunc cetera.	**10** Fica sabendo agora do resto.	José Dejalma Dezotti
Pro Appio nos hic omnia facimus, honeste tamen sed plane libenter;	Por Ápio, nós fizemos aqui tudo, enfim de modo honrado, mas de muito bom grado;	José Dejalma Dezotti
nec enim ipsum odimus et Brutum amamus et Pompeius mirifice a me contendit, quem mehercule plus plusque in dies diligo.	pois não o odeio e gosto de Bruto, e Pompeu, a quem, por hércules, estimo mais e mais a cada dia, me pede com insistência de modo admirável.	José Dejalma Dezotti
C. Coelium huc quaestorem uenire audisti?	Ouviste que o questor Caio Célio vem aqui?	José Dejalma Dezotti
Nescio quid sit hominis.	Não sei que classe de homem é.	José Dejalma Dezotti
\[Sed\] Pammenia illa mihi non placent.	\[Mas\] aquele caso de Pamenes não me agrada.	José Dejalma Dezotti
Ego me spero Athenis fore mense Septembri.	Eu espero estar em Atenas no mês de setembro.	José Dejalma Dezotti
Tuorum itinerum tempora scire sane uelim.	Queria muito saber as datas de tuas viagens.	José Dejalma Dezotti
εὐήθειαν Semproni Rufi cognoui ex epistula tua Corcyraea.	Soube da *ingenuidade* de Semprônio Rufo por tua carta de Corcira.	José Dejalma Dezotti
Quid quaeris? Inuideo potentiae Vestori.	O que queres? Invejo o poder de Vestório.	José Dejalma Dezotti
Cupiebam etiam nunc plura garrire, sed lucet;	Eu ainda desejava falar mais agora, mas é dia;	José Dejalma Dezotti
urget turba, festinat Philogenes.	a turba me aperta, Filógenes tem pressa.	José Dejalma Dezotti
Valebis igitur et ualere Piliam et Caeciliam nostram iubebis litteris et saluebis a meo Cicerone.	Saúde, portanto, para ti e manda por carta saúde para as nossas queridas Pília e Cecília e recebe um salve de meu Cícero.	José Dejalma Dezotti
		José Dejalma Dezotti
**3**	**3**	José Dejalma Dezotti
Cicero Attico sal.	Cícero saúda Ático.	José Dejalma Dezotti
**1** Etsi nihil sane habebam noui quod post accidisset quam dedissem ad te Philogeni liberto tuo litteras, tamen cum Philotimum Romam remitterem, scribendum aliquid ad te fuit.	**1** Ainda que eu não tenha nada de novo que tenha acontecido depois que eu tinha entregado ao teu liberto Filógenes a carta para ti, uma vez que mando Filótimo de volta para Roma, tive de te escrever alguma coisa.	José Dejalma Dezotti
Ac primum illud quod me maxime angebat (non quo me aliquid iuuare posses; quippe?	Primeiro o que mais me angustia (não que possas me ajudar; por quê?	José Dejalma Dezotti
res enim est in manibus, tu autem abes longe gentium, “πολλὰ δ' ἐν μεταιχμίῳ νότος κυλίνδει κύματ' εὐρείης ἁλός”):	Pois a coisa está em mãos, tu, porém, estás longe, “*e entre mim e ti muitas ondas do vasto mar o Noto faz ondular*”)	José Dejalma Dezotti
obrepit dies, ut uides (mihi enim a. d. III Kal. Sext. de prouincia decedendum est), nec succeditur.	como vês, chega pouco a pouco o dia (pois eu devo ir embora da província no terceiro dia antes das calendas de agosto \[30 de julho\]), e não há sucessor.	José Dejalma Dezotti
Quem relinquam qui prouinciae praesit?	Quem eu vou deixar para estar à frente da província?	José Dejalma Dezotti
Ratio quidem et opinio hominum postulat fratrem, primum quod uidetur esse honos, nemo igitur potior;	A lógica e a opinião das pessoas pedem meu irmão, primeiro porque parece ser uma honra, portanto ninguém é melhor;	José Dejalma Dezotti
deinde quod solum habeo praetorium.	segundo porque o tenho como único da categoria pretória.	José Dejalma Dezotti
Pomptinus enim ex pacto et conuento (nam ea lege exierat) iam a me discesserat.	Pois Pomptino, segundo o acordo e a convenção (pois ele tinha vindo com essa condição) já tinha se afastado de mim.	José Dejalma Dezotti
Quaestorem nemo dignum putat;	Ninguém considera digno o meu questor;	José Dejalma Dezotti
etenim est leuis, libidinosus, tagax.	pois é superficial, libidinoso, gatuno.	José Dejalma Dezotti
**2** De fratre autem primum illud est:	**2** Por outro lado, quanto a meu irmão, o primeiro ponto é esse:	José Dejalma Dezotti
persuaderi ei non posse arbitror;	julgo não poder persuadi-lo;	José Dejalma Dezotti
odit enim prouinciam, et hercule nihil odiosius, nihil molestius.	pois ele odeia província e, por hércules, não há nada mais odioso, nada mais penoso.	José Dejalma Dezotti
Deinde ut mihi nolit negare, quidnam mei sit offici?	Depois, mesmo que ele não queira negar-me, qual é o meu dever?	José Dejalma Dezotti
Cum bellum esse in Syria magnum putetur, id uideatur in hanc prouinciam erupturum, hic praesidi nihil sit, sumptus annuus decretus sit, uideaturne aut pietatis esse meae fratrem relinquere aut diligentiae nugarum aliquid relinquere?	Quando se pensa que há na Síria uma grande guerra, essa parece que irromperá nesta província, aqui não há nenhuma proteção, o gasto foi decretado para um ano, pareceria por acaso ser amor de minha parte deixar aqui meu irmão ou diligência deixar algumas bagatelas?	José Dejalma Dezotti
Magna igitur, ut uides, sollicitudine adficior, magna inopia consili.	Portanto, como vês, sou atormentado por uma grande preocupação, por uma grande falta de conselho.	José Dejalma Dezotti
Quid quaeris? Toto negotio nobis opus non fuit.	O que queres? Não havia necessidade para nós de todo esse assunto.	José Dejalma Dezotti
Quanto tua prouincia melior\!	Quão melhor é a tua província\!	José Dejalma Dezotti
Decedes cum uoles, nisi forte iam decessisti;	Vais embora quando quiseres, se é que já não foste;	José Dejalma Dezotti
quem uidebitur praeficies Thesprotiae et Chaoniae.	porás à frente de Tesprótia e Caônia a quem te parecer melhor.	José Dejalma Dezotti
Necdum tamen ego Quintum conueneram, ut iam si id placeret scirem possetne ab eo impetrari;	Contudo, eu ainda não me encontrei com Quinto, para que eu soubesse se isso lhe agradava ou se isso podia ser conseguido dele;	José Dejalma Dezotti
nec tamen, si posset, quid uellem habebam.	e se pudesse, eu, contudo, não sei o quero.	José Dejalma Dezotti
Hoc est igitur eius modi.	Isto está, portanto, desse modo.	José Dejalma Dezotti
**3** Reliqua plena adhuc et laudis et gratiae, digna iis libris quos dilaudas:	**3** O restante, até agora, cheio de louvor e de graça, digno desses livros que muito louvas:	José Dejalma Dezotti
conseruatae ciuitates, cumulate publicanis satis factum;	as cidades salvas, se tem plenamente satisfação aos publicanos;	José Dejalma Dezotti
offensus contumelia nemo, decreto iusto et seuero perpauci, nec tamen quisquam ut queri audeat;	ninguém ofendido com injúria, muito poucos punidos por decreto justo e severo e, contudo, ninguém ousa queixar-se;	José Dejalma Dezotti
res gestae dignae triumpho, de quo ipso nihil cupide agemus, sine tuo quidem consilio certe nihil.	façanhas dignas de triunfo, sobre o qual não faremos nada com avidez, nada com certeza sem realmente o teu conselho.	José Dejalma Dezotti
Clausula est difficilis in tradenda prouincia;	É difícil a conclusão em transmitir a província;	José Dejalma Dezotti
sed haec deus aliquis gubernabit.	mas algum deus a governará.	José Dejalma Dezotti
**4** De urbanis rebus scilicet plura tu scis, saepius et certiora audis;	**4** Quanto aos assuntos da cidade, evidentemente tu sabes mais, ouves notícias mais frequentemente e mais certas;	José Dejalma Dezotti
equidem doleo non me tuis litteris certiorem fieri.	na verdade, me dói não ser melhor informado por tuas cartas.	José Dejalma Dezotti
Huc enim odiosa adferebantur de Curione, de Paulo;	Pois aqui são trazidas odiosas a respeito de Curião, de Paulo;	José Dejalma Dezotti
non quo ullum periculum uideam stante Pompeio uel etiam sedente, ualeat modo;	não que eu vojo algum perigo com Pompeu estando de pé ou até mesmo estando sentado, desde que esteja bem de saúde;	José Dejalma Dezotti
sed mehercule Curionis et Pauli, meorum familiarium, uicem doleo.	mas por hércules me dói a sorte de Curião e de Paulo, meus íntimos amigos.	José Dejalma Dezotti
Formam igitur mihi totius rei publicae, si iam es Romae aut cum eris, uelim mittas quae mihi obuiam ueniat, ex qua me fingere possim et praemeditari quo animo accedam ad urbem;	Eu queria, portanto, se já estás em Roma ou quando estiveres, que me mandasses um quadro de toda a república que venha ao meu encontro e a partir dela eu possa modelar e planejar com que espírito aproximarei da cidade;	José Dejalma Dezotti
est enim quiddam aduenientem non esse peregrinum atque hospitem.	pois é alguma coisa que quem chega não seja estrangeiro ou hóspede.	José Dejalma Dezotti
**5** Et quod paene praeterii, Bruti tui causa, ut saepe ad te scripsi, feci omnia.	**5** E o que quase deixei passar, fiz de tudo por teu Bruto, como muitas vezes te escrevi.	José Dejalma Dezotti
Cyprii numerabant;	Os cíprios estão pagando;	José Dejalma Dezotti
sed Scaptius centesimis renouato in singulos annos faenore contentus non fuit.	mas Escápcio não ficou contente com doze por cento de juro acumulado a cada ano.	José Dejalma Dezotti
Ariobarzanes non in Pompeium prolixior per ipsum quam per me in Brutum.	Ariobarzanes não é mais liberal com Pompeu por seu próprio interesse do que pelo meu com Bruto.	José Dejalma Dezotti
Quem tamen ego praestare non poteram;	Eu, contudo, não posso ser fiador dele;	José Dejalma Dezotti
erat enim rex perpauper aberamque ab eo ita longe ut nihil possem nisi litteris, quibus pugnare non destiti.	pois o rei está muito pobre e eu estou tão longe dele que eu nada posso a não ser por cartas, com as quais não deixo de lutar.	José Dejalma Dezotti
Summa haec est:	Em suma é isto:	José Dejalma Dezotti
pro ratione pecuniae liberalius est Brutus tractatus quam Pompeius.	à proporção do dinheiro, Bruto é tratado com mais generosidade do Pompeu.	José Dejalma Dezotti
Bruto curata hoc anno talenta circiter C, Pompeio in sex mensibus promissa CC.	A Bruto foram pagos este ano cerca de 100 talentos, a Pompeu foram prometidos 200 para dentro de seis meses.	José Dejalma Dezotti
Iam in Appi negotio quantum tribuerim Bruto dici uix potest.	Agora, no caso de Ápio, mal pode ser dito o quanto eu concedi a Bruto.	José Dejalma Dezotti
Quid est igitur quod laborem?	Por que então me angustiar?	José Dejalma Dezotti
Amicos habet meras nugas, Matinium, Scaptium;	Ele tem por amigos meras nulidades, Matínio, Escápcio;	José Dejalma Dezotti
qui quia non habuit a me turmas equitum quibus Cyprum uexaret, ut ante me fecerat, fortasse suscenset, aut quia praefectus non est, quod ego nemini tribui negotiatori (non C. Vennonio, meo familiari, non tuo, M. Laenio), et quod tibi Romae ostenderam me seruaturum;	e este, porque não obteve de mim tropas de cavaleiros com as quais acometeria Chipre, como tinha feito antes de mim, talvez esteja irritado, ou porque não é prefeito, posto que não concedi a nenhum comerciante (nem a Caio Venônio, meu amigo íntimo, nem ao teu, Marco Lênio), e eu tinha te mostrado em Roma que iria manter isso;	José Dejalma Dezotti
in quo perseueraui.	e nisso eu fiquei firme.	José Dejalma Dezotti
Sed quid poterit queri is qui auferre pecuniam cum posset noluit?	Mas de que poderá se queixar quem não quis tomar seu dinheiro quando podia?	José Dejalma Dezotti
†Aut Scaptius† qui in Cappadocia fuit puto esse satis factum.	†Escápcio†, que estava na Capadócia, acho que está satisfeito.	José Dejalma Dezotti
Is a me tribunatum cum accepisset, quem ego ex Bruti litteris ei detulissem, postea scripsit ad me se uti nolle eo tribunatu.	Tendo ele recebido de mim o tribunato, que eu lhe tinha oferecido por recomendação de uma carta de Bruto, escreveu-me posteriormente que não queria desfrutar desse tribunato.	José Dejalma Dezotti
**6** Gauius est quidam, cui cum praefecturam detulissem Bruti rogatu multa et dixit et fecit cum quadam mea contumelia, P. Clodi canis.	**6** Há um tal Gávio, que, depois de eu lhe ter oferecido uma prefeitura a pedido de Bruto, não só disse como fez muitas coisas com algum insulto a mim, um cão de Públio Clódio.	José Dejalma Dezotti
Is me nec proficiscentem Apamea prosecutus est nec, cum postea in castra uenisset atque inde discederet, num quid uellem rogauit et fuit aperte mihi nescio qua re non amicus.	Ele não me escoltou quando parti de Apameia nem, quando veio posteriormente ao acampamento e dali se foi, perguntou se eu queria alguma coisa e não sei por que motivo foi claramente não amigo meu.	José Dejalma Dezotti
Hunc ego si in praefectis habuissem, quem tu me hominem putares?	Se eu o tivesse entre os prefeitos, que homem tu me julgarias?	José Dejalma Dezotti
Qui, ut scis, potentissimorum hominum contumaciam numquam tulerim, ferrem huius adseculae?	Eu, que, como sabes, nunca tolerei a altivez dos homens mais poderosos, iria tolerar a desse lacaio?	José Dejalma Dezotti
Etsi hoc plus est quam ferre, tribuere etiam aliquid benefici et honoris.	Ainda que isto seja mais que tolerar, conceder até mesmo algum benefício e honra.	José Dejalma Dezotti
Is igitur Gauius, cum Apameae me nuper uidisset Romam proficiscens, me ita appellauit ut Culleolum uix auderem:	Esse Gávio, portanto, como, quando partia para Roma, me tivesse visto recentemente em Apameia, me abordou de um tal modo como eu dificilmente ousaria abordar Culeolo:	José Dejalma Dezotti
“Vnde” inquit “me iubes petere cibaria praefecti?”	“De onde” diz ele “me ordenas procurar a comida do prefeito?”	José Dejalma Dezotti
Respondi lenius quam putabant oportuisse qui aderant, me non instituisse iis dare cibaria quorum opera non essem usus.	Respondi, de um modo mais brando do que consideravam ser conveniente os que estavam presentes, que eu não tinha instituído dar comida àqueles cujo serviço eu não tinha utilizado.	José Dejalma Dezotti
Abiit iratus.	Foi embora irado.	José Dejalma Dezotti
**7** Huius nebulonis oratione si Brutus moueri potest, licebit eum solus ames, me aemulum non habebis.	**7** Se Bruto pode se deixar levar pelo discurso desse patife, será lícito que tu o estimes sozinho, não me terás como rival.	José Dejalma Dezotti
Sed illum eum futurum esse puto qui esse debet;	Mas acho que ele será aquele que deve ser;	José Dejalma Dezotti
tibi tamen causam notam esse uolui et ad ipsum haec perscripsi diligentissime.	contudo, eu quis que a questão fosse conhecida de ti e a ele próprio escrevi muito detalhadamente essas coisas.	José Dejalma Dezotti
Omnino (soli enim sumus) nullas umquam ad me litteras misit Brutus, ne proxime quidem de Appio, in quibus non inesset adrogans et ἀκοινονόητον aliquid.	Absolutamente nunca (pois estamos entre nós) Bruto me enviou uma carta, nem mesmo mais recentemente acerca de Ápio, na qual não haja algo arrogante e *sem sentido comum*.	José Dejalma Dezotti
Tibi autem ualde solet in ore esse:	Tu, porém, costumas ter com frequência na boca:	José Dejalma Dezotti
“Granius autem non contemnere se et reges odisse superbos.”	“Mas Grânio não se menospreza e odeia os reis soberbos.”	José Dejalma Dezotti
In quo tamen ille mihi risum magis quam stomachum mouere solet;	Nisso, contudo, ele costuma provocar em mim mais riso do que raiva;	José Dejalma Dezotti
sed plane parum cogitat quid scribat aut ad quem.	mas claramente pensa pouco o que escreve ou a quem.	José Dejalma Dezotti
**8** Q. Cicero puer legit, ut opinor, et certe, epistulam inscriptam patri suo;	**8** O menino Quinto Cícero leu, conforme opino, e com certeza, a carta escrita para o pai dele;	José Dejalma Dezotti
solet enim aperire, idque de meo consilio, si quid forte sit quod opus sit sciri.	pois costuma abri-las, e isso por conselho meu, se por acaso há algo que é necessário que se saiba.	José Dejalma Dezotti
In ea autem epistula erat idem illud de sorore quod ad me.	Nessa carta estava aquilo mesmo que me escreveste a respeito de tua irmã.	José Dejalma Dezotti
Mirifice conturbatum uidi puerum;	Vi o garoto extremamente perturbado;	José Dejalma Dezotti
lacrimans mecum est questus.	lamentou-se comigo chorando.	José Dejalma Dezotti
Quid quaeris? Miram in eo pietatem, suauitatem humanitatemque perspexi;	O que queres? Notei nele um admirável carinho, doçura e delicadeza;	José Dejalma Dezotti
quo maiorem spem habeo nihil fore aliter ac deceat.	por isso tenho a maior esperança de que não será nada diferente do que convém.	José Dejalma Dezotti
Id te igitur scire uolui.	Quis, portanto, que tu soubesses isso.	José Dejalma Dezotti
**9** Ne illud quidem praetermittam:	**9** Nem mesmo o seguinte eu vou deixar passar:	José Dejalma Dezotti
Hortensius filius fuit Laodiceae gladiatoribus, flagitiose et turpiter.	Hortênsio filho se comportou nos jogos de gladiadores em Laodicéia de modo escandaloso e vergonhoso	José Dejalma Dezotti
Hunc ego patris causa uocaui ad cenam quo die uenit, et eiusdem patris causa nihil amplius.	Por causa de seu pai o convidei para jantar no dia em que chegou, e por causa do mesmo pai nada mais.	José Dejalma Dezotti
Is mihi dixit se Athenis me exspectaturum ut mecum decederet.	Ele me disse que me esperaria em Atenas para ir embora comigo.	José Dejalma Dezotti
“Recte” inquam;	“Tudo bem” eu digo;	José Dejalma Dezotti
quid enim dicerem?	pois o que eu ia dizer?	José Dejalma Dezotti
Omnino puto nihil esse quod dixit;	Acho que não significa absolutamente nada o que ele disse;	José Dejalma Dezotti
nolo quidem, ne offendam patrem, quem mehercule multum diligo.	Na verdade, não quero, para não ofender seu pai, a quem, por hércules, muito estimo.	José Dejalma Dezotti
Sin fuerit meus comes, moderabor ita ne quid eum offendam quem minime uolo.	Mas se ele for meu companheiro, vou agir moderadamente a ponto de não ofender aquele que de modo algum quero.	José Dejalma Dezotti
**10** Haec sunt.	**10** Estas são as coisas.	José Dejalma Dezotti
Etiam illud: orationem Q. Celeris mihi uelim mittas contra M. Seruilium.	Mais isso: gostaria que me enviasses o discurso de Quinto Céler contra Marco Servílio.	José Dejalma Dezotti
Litteras mitte quam primum;	Mande um carta o mais breve possível;	José Dejalma Dezotti
si nihil erit, id ipsum scribes, nihil fieri, uel per tuum tabellarium.	se não houver nada, escreve isso mesmo, que não há nada, até mesmo por meio de teu carteiro.	José Dejalma Dezotti
Piliae et filiae salutem.	Diz saúde para Pília e para tua filha.	José Dejalma Dezotti
Cura ut ualeas.	Cuida para que fiques bem.	José Dejalma Dezotti
		José Dejalma Dezotti
**4**	**4**	José Dejalma Dezotti
Cicero Attico sal.	Cícero saúda Ático.	José Dejalma Dezotti
**1** Tarsum ueni Non. Iun.	**1** Cheguei em Tarso nas nonas de junho \[5 de junho\]	José Dejalma Dezotti
Ibi me multa mouerunt:	Ali muitas coisas me perturbaram:	José Dejalma Dezotti
magnum in Syria bellum, magna in Cilicia latrocinia, mihi difficilis ratio administrandi, quod paucos dies habebam reliquos annui muneris, illud autem difficillimum, relinquendus erat ex senatus consulto qui praeesset.	a grande guerra na Síria, grandes roubos na Cilícia, um modo difícil para mim de administrar, porque eu tinha poucos dias restantes de meu cargo anual, e o mais difícil, por um decreto do senado, era preciso deixar alguém que ficasse à frente da província.	José Dejalma Dezotti
Nihil minus probari poterat quam quaestor Mescinius.	Nada pode ser menos admissível do que o questor Mescínio.	José Dejalma Dezotti
Nam de Coelio nihil audiebamus.	Já acerca de Célio nada ouvimos.	José Dejalma Dezotti
Rectissimum uidebatur Quintum fratrem cum imperio relinquere;	Me parece o mais certo deixar meu irmão Quinto com o comando;	José Dejalma Dezotti
in quo multa molesta, discessus noster, belli periculum, militum improbitas, sescenta praeterea.	nisso há muitos incômodos, a nossa separação, o perigo da guerra, a má qualidade dos soldados, além de outros seiscentos problemas.	José Dejalma Dezotti
O rem totam odiosam\!	Ó coisa inteira odiosa\!	José Dejalma Dezotti
Sed haec fortuna uiderit, quoniam consilio non multum uti licet.	Mas isso a fortuna verá, já que não há muita possibilidade de lançar mão de conselho.	José Dejalma Dezotti
**2** Tu quando Romam saluus (ut spero) uenisti, uidebis, ut soles, omnia quae intelleges nostra interesse, in primis de Tullia mea, cuius de condicione quid mihi placeret scripsi ad Terentiam cum tu in Graecia esses;	**2** Tu, visto que (como espero) chegaste em Roma são e salvo, olharás, como costumas, tudo o que entendes ser do meu interesse, sobretudo em relação à minha Túlia, sobre cujo casamento escrevi para Terência o que me agradava, enquanto tu estavas na Grécia;	José Dejalma Dezotti
deinde de honore nostro.	depois acerca de minha honraria.	José Dejalma Dezotti
Quod enim tu afuisti, uereor ut satis diligenter actum in senatu sit de litteris meis.	Pois uma vez que tu estiveste ausente, receio que não se tratou de minha carta de um modo suficientemente atento.	José Dejalma Dezotti
**3** Illud praeterea μυστικώτερον ad te scribam, tu sagacius odorabere.	**3** Além do mais, vou te escrever *com o maior mistério*, tu sagazmente sentirás o cheiro.	José Dejalma Dezotti
τῆς δάμαρτός μου ὁ ἀπελεύθερος (οἶσθα ὃν λέγω) ἔδοξέ μοι πρώην, ἐξ ὧν ἀλογευόμενος παρεφθέγγετο, πεφυρακέναι τὰς ψήφους ἐκ τῆς ὠνῆς τῶν ὑπαρχόντων τῶν τοῦ Κροτωνιάτου τυραννοκτόνου. δέδοικα δὴ μή τι \- νοήσεις δήπου. τοῦτο δὴ περισκεψάμενος τὰ λοιπὰ ἐξασφάλισαι.		José Dejalma Dezotti
Non queo tantum quantum uereor scribere;	Não posso escrever tudo que temo;	José Dejalma Dezotti
tu autem fac ut mihi tuae litterae uolent obuiae.	Tu, porém, faze com que uma carta tua voe ao meu encontro.	José Dejalma Dezotti
Haec festinans scripsi in itinere atque agmine.	Estas coisas eu escrevi às pressas em viagem e com o exército.	José Dejalma Dezotti
Piliae et puellae Caeciliae bellissimae salutem dices.	Manda saúde a Pília e à belíssima menina Cecília.	José Dejalma Dezotti
		José Dejalma Dezotti
**5**	**5**	José Dejalma Dezotti
Cicero Attico sal.	Cícero saúda Ático.	José Dejalma Dezotti
**1** Nunc quidem profecto Romae es, quo te, si ita est, saluum uenisse gaudeo;	**1** Agora com toda certeza estás em Roma, aonde me alegro de teres são e salvo, se é assim;	José Dejalma Dezotti
unde quidem quam diu afuisti, magis a me abesse uidebare quam si domi esses.	por todo o tempo que estiveste afastado daí, parecias estar mais afastado de mim do que se estivesses em casa.	José Dejalma Dezotti
Minus enim mihi meae notae res erant, minus etiam publicae.	Pois me eram menos conhecidos os meus assuntos, menos também os públicos.	José Dejalma Dezotti
Qua re uelim, etsi (ut spero) te haec legente aliquantum iam uiae processero, tamen obuias mihi litteras quam argutissimas de omnibus rebus crebro mittas, in primis de quo scripsi ad te antea.	Por isso eu gostaria, ainda que (como espero), quando estiveres lendo esta, já terei avançado um bom tanto do caminho, que mesmo assim mandasses com frequência ao meu encontro cartas o mais minuciosas possível sobre todos os assuntos, principalmente sobre o que te escrevi anteriormente.	José Dejalma Dezotti
τῆς ξυναόρου τῆς ἐμῆς οὑξελεύθερος ἔδοξέ μοι θαμὰ βατταρίζων καὶ ἀλύων ἐν τοῖς ξυλλόγοις καὶ ταῖς λέσχαις ὑπό τι πεφυρακέναι τὰς ψήφους ἐν τοῖς ὑπάρχουσιν τοῖς τοῦ Κροτωνιάτου.		José Dejalma Dezotti
**2** Hoc tu indaga, ut soles, at hoc magis:	**2** Investiga isso, como costumas, e mais isto:	José Dejalma Dezotti
ἐξ ἄστεως ἑπταλόφου στείχων παρέδωκεν μνῶν †καμν† ὀφείλημα τῷ Καμίλλῳ, ἑαυτόν τε ὀφείλοντα μνᾶς κδ′ ἐκ τῶν Κροτωνιατικῶν καὶ ἐκ τῶν Χερρονησιτικῶν μη′ καὶ μνᾶς κληρονομῆσαι χμ′ \[κμ\]. τούτων δὲ μηδὲ ὀβολὸν διευλυτῆσθαι, πάντων ὀφειληθέντων τοῦ δευτέρου μηνὸς τῇ νουμηνίᾳ. τὸν δὲ ἀπελεύθερον αὐτοῦ, ὄντα ὁμώνυμον τῷ Κόνωνος πατρί, μηδὲν ὁλοσχερῶς πεφροντικέναι. ταῦτα οὖν πρῶτον μὲν ἵνα πάντα σῴζηται, δεύτερον δὲ ἵνα μηδὲ τῶν τόκων ὀλιγωρήσῃς τῶν ἀπὸ τῆς προεκκειμένης ἡμέρας. ὅσας αὐτοῦ ἠνέγκαμεν σφόδρα δέδοικα· καὶ γὰρ παρῆν πρὸς ἡμᾶς κατασκεψόμενος καί τι σχεδὸν ἐλπίσας· ἀπογνοὺς δ' ἀλόγως ἀπῆλθεν ἐπειπών 'εἴκω·“αἰσχρόν τοι δηρόν τε μένειν...”, meque obiurgauit uetere prouerbio 'τὰ μὲν διδόμενα ...”.	... e me censurou com o velho provérbio...	José Dejalma Dezotti
**3** Reliqua uide et quantum fieri potest perspice.	**3** Vê o restante e examina com atenção o que pode ser feito.	José Dejalma Dezotti
Nos etsi annuum tempus \[est\] prope iam emeritum habebamus (dies enim XXXIII erant reliqui), sollicitudine prouinciae tamen uel maxime urgebamur.	Nós, embora tenhamos já quase acabado o nosso tempo (pois restam 33 dias), somos, contudo, sobremaneira assolados pela preocupação com a província.	José Dejalma Dezotti
Cum enim arderet Syria bello et Bibulus in tanto maerore suo maximam curam belli sustineret ad meque legati eius et quaestor et amici eius litteras mitterent ut subsidio uenirem, etsi exercitum infirmum habebam, auxilia sane bona sed ea Galatarum, Pisidarum, Lyciorum (haec enim sunt nostra robora), tamen esse officium meum putaui exercitum habere quam proxime hostem quoad mihi praeesse prouinciae per senatus consultum liceret.	Pois embora a Síria ardesse em guerra e Bíbulo, em meio de sua tão grande dor, tomasse a seu cargo o maior peso da guerra, e seus legados e seu questor e seus amigos me enviassem carta para que eu viesse em sua ajuda, ainda que eu tivesse um fraco exército, mas tropas auxiliares bastante boas de gálatas, písídas, lícios (pois estes são as nossas forças), mesmo assim considerei ser o meu dever ter o exército o mais próximos possível do inimigo enquanto me fosse permitido estar à frente da província pelo decreto do senado.	José Dejalma Dezotti
Sed quo ego maxime delectabar, Bibulus molestus mihi non erat, de omnibus rebus scribebat ad me potius.	Mas aquilo com que eu mais me comprazia é que Bíbulo não estava aborrecido comigo, me escrevia de preferência sobre todos os assuntos.	José Dejalma Dezotti
Et mihi decessionis dies λεληθότως obrepebat.	E o dia da partida chega para mim *imperceptivelmente*.	José Dejalma Dezotti
Qui cum aduenerit, ἄλλο πρόβλημα, quem praeficiam, nisi Caldus quaestor uenerit;	E quando este chegar, *outro problema*, a quem porei no comando, se o questor Caldo não chegar;	José Dejalma Dezotti
de quo adhuc nihil certi habebamus.	a respeito dele não tínhamos até o momento nada de certo.	José Dejalma Dezotti
**4** Cupiebam mehercule longiorem epistulam facere, sed nec erat res de qua scriberem nec iocari prae cura poteram.	**4** Eu desejava, por hércules, compor uma carta mais longa, mas nem havia assunto sobre o qual escrever nem eu podia joguetear por causa de minha preocupação.	José Dejalma Dezotti
Valebis igitur et puellae salutem Atticulae tuae dices nostraeque Piliae.	Ficarás bem, portanto, e dizes saúde à tua garota Atícula e à nossa Pília.	José Dejalma Dezotti
		José Dejalma Dezotti
**6**	**6**	José Dejalma Dezotti
Cicero Attico sal.	Cícero saúda Ático.	José Dejalma Dezotti
**1** Ego dum in prouincia omnibus rebus Appium orno, subito sum factus accusatoris eius socer.	**1** Enquanto eu em mnha província honro Ápio por todas as coisas, de repente me tornei sogro de seu acusador.	José Dejalma Dezotti
“Id quidem” inquis “di adprobent\!”.	“Que os deuses realmente favoreçam isso\!” dizes.	José Dejalma Dezotti
Ita uelim, teque ita cupere certo scio.	Eu queria assim e sei com certeza que tu desejas assim.	José Dejalma Dezotti
Sed crede mihi, nihil minus putaram ego, qui de Ti. Nerone, qui mecum egerat, certos homines ad mulieres miseram;	Mas acredita em mim, era a última coisa que eu achava, eu, que tinha enviado às mulheres \[Terência e Túlia\] pessoas de confiança a respeito de Tibério Nerão, que tinha tratado comigo;	José Dejalma Dezotti
qui Romam uenerunt factis sponsalibus.	que chegaram em Roma, depois de realizados os esponsais.	José Dejalma Dezotti
Sed hoc spero melius.	Mas espere que isso seja o melhor.	José Dejalma Dezotti
Mulieres quidem ualde intellego delectari obsequio et comitate adulescentis.	Entendo que realmente as mulheres muito se deleitam com a cortesia e amabilidade do jovem.	José Dejalma Dezotti
Cetera noli ἐξακανθίζειν.	Quanto ao resto, *não arranques os espinhos*”.	José Dejalma Dezotti
**2** Sed heus tu, πυροὺς εἰς δῆμον Athenis?	**2** Mas olha, *trigo para o povo* em Atenas?	José Dejalma Dezotti
Placet hoc tibi?	Isso te agrada?	José Dejalma Dezotti
Etsi non impediebant mei certe libri;	Ainda que certamente meus livros não impediam;	José Dejalma Dezotti
non enim ista largitio fuit in ciuis sed in hospites liberalitas.	pois essa não foi uma generosidade para os cidadãos, mas uma liberalidade para os forasteiros.	José Dejalma Dezotti
Me tamen de Academiae προπύλῳ iubes cogitare, cum iam Appius de Eleusine non cogitet?	Contudo, me mandas pensar a respeito do *pórtico* da Academia, visto que Ápio já não pensa no de Elêusis?	José Dejalma Dezotti
De Hortensio te certo scio dolere.	Sei com certeza que tu sofres no que concerne a Hortênsio.	José Dejalma Dezotti
Equidem excrucior;	Eu certamente fico angustiado;	José Dejalma Dezotti
decreram enim ualde cum eo familiariter uiuere.	pois eu tinha decidido viver na maior amizade com ele.	José Dejalma Dezotti
**3** Nos prouinciae praefecimus Coelium.	**3** Nós pusemos Célio à frente da província.	José Dejalma Dezotti
“Puerum” inquies “et fortasse fatuum et non grauem et non continentem.”	“Um menino” dirás “e talvez tolo e não sério e não controlado.”	José Dejalma Dezotti
Adsentior;	Concordo;	José Dejalma Dezotti
fieri non potuit aliter.	não se pôde fazer de outro modo.	José Dejalma Dezotti
Nam quas multo ante tuas acceperam litteras in quibus ἐπέχειν te scripseras quid esset mihi faciendum de relinquendo, eae me pungebant.	Pois a carta tua que eu tinha recebido muito antes, na qual tinhas escrito que *não tinhas opinião formada* sobre o que eu devia fazer acerca de minha sucessão, me atormentava.	José Dejalma Dezotti
Videbam enim quae tibi essent ἐποχῆς causae, et erant eaedem mihi.	Pois eu via quais eram os motivos de tua dúvida, e eram os mesmos para mim.	José Dejalma Dezotti
Puero traderem?	A confiaria a um menino?	José Dejalma Dezotti
Id rei publicae non utile.	Isso não seria útil para a república.	José Dejalma Dezotti
Fratri autem? Illud non utile nobis.	Ao meu irmão? Aquilo não seria útil a nós.	José Dejalma Dezotti
Nam praeter fratrem nemo erat quem sine contumelia quaestori, nobili praesertim, anteferrem.	Pois além de meu irmão não havia ninguém que eu anteporia, sem ultrae, ao meu questor, especialmente nobre.	José Dejalma Dezotti
Tamen, dum impendere Parthi uidebantur, statueram fratrem relinquere, aut etiam rei publicae causa contra senatus consultum ipse remanere;	Contudo, enquanto os partos pareciam ameaçar, eu tinha decidido deixar meu irmão, ou ainda eu próprio por causa da república permanecer contra o decreto do senado;	José Dejalma Dezotti
qui postea quam incredibili felicitate discesserunt, sublata dubitatio est.	depois que eles, por incrível felicidade, se retiraram, minha dúvida foi desfeita.	José Dejalma Dezotti
Videbam sermones:	Eu via os falatórios:	José Dejalma Dezotti
“Hui, fratrem reliquit\!	“Ah, deixou o irmão\!	José Dejalma Dezotti
Num est hoc non plus annum obtinere prouinciam?	Acaso isto não é ter a província por mais de um ano?	José Dejalma Dezotti
Quid quod senatus eos uoluit praeesse prouinciis qui non praefuissent?	O que o senado quer é que que estejam no comando das províncias os que não estiveram antes?	José Dejalma Dezotti
At hic triennium.”	Mas este por três anos.”	José Dejalma Dezotti
**4** Ergo haec ad populum:	**4** Isto, portanto, para o povo:	José Dejalma Dezotti
quid quae tecum?	e contigo?	José Dejalma Dezotti
Numquam essem sine cura, si quid iracundius aut contumeliosius aut neglegentius, quae fert uita hominum.	Eu nunca estaria sem preocupação, se houvesse algo com mais ira ou com mais ofensa ou com mais negligência, coisas que a vida dos homens traz.	José Dejalma Dezotti
Quid si quid filius puer et puer bene sibi fidens?	E se fosse o filho dele, um menino, e um menino bem confiante em si mesmo?	José Dejalma Dezotti
Qui esset dolor	Que dor seria?	José Dejalma Dezotti
Quem pater non dimittebat teque id censere moleste ferebat.	Seu pai não o deixaria ir e se indignaria de que pensasses isso.	José Dejalma Dezotti
At nunc Coelius non dico equidem “quod egerit”, sed tamen multo minus laboro.	Mas agora Célio, não digo “o que fêz”, mas mesmo assim sofro muito menos.	José Dejalma Dezotti
Adde illud.	Acrescenta isto:	José Dejalma Dezotti
Pompeius, eo robore uir, iis radicibus, Q. Cassium sine sorte delegit, Caesar Antonium:	Pompeu, um homem com essa força, com essas raízes, escolheu Quinto Cássio sem sorteio, César escolheu Antônio:	José Dejalma Dezotti
ego sorte datum offenderem, ut etiam inquireret in eum quem reliquissem?	iria eu ofender a quem tinha sido entregue a mim por sorteio para que ele espionasse aquele que eu tivesse deixado?	José Dejalma Dezotti
Hoc melius, et huius rei plura exempla, senectuti quidem nostrae profecto aptius.	Isto é melhor e há muitos exemplos disso, sem dúvida, na verdade, o mais adequado para a nossa velhice.	José Dejalma Dezotti
At te apud eum, di boni, quanta in gratia posui\!	Em que grande harmonia te pus com ele, bons deuses\!	José Dejalma Dezotti
Eique legi litteras non tuas sed librari tui.	Li para ele a carta não tua, mas de teu secretário.	José Dejalma Dezotti
Amicorum litterae me ad triumphum uocant, rem a nobis, ut ego arbitror, propter hanc παλιγγενεσίαν nostram non neglegendam.	As cartas de meus amigos me convocam ao triunfo, uma coisa que, segundo eu julgo, não deve ser negligenciada por nós por causa desse nosso *renascimento*.	José Dejalma Dezotti
Qua re tu quoque, mi Attice, incipe id cupere, quo nos minus inepti uideamur.	Por isso, tu também, meu querido Ático, começa a desejar isso, para que eu pareça menos tolo.	José Dejalma Dezotti
		José Dejalma Dezotti
**7**	**7**	José Dejalma Dezotti
Cicero Attico sal.	Cícero saúda Ático.	José Dejalma Dezotti
**1** Quintus filius pie sane (me quidem certe multum hortante, sed currentem) animum patris sui sorori tuae reconciliauit.	**1** Quinto filho sem dúvida com seu amor filial (tendo eu certamente, na verdade, o exortado muito, mas ele foi rápido) reconciliou o espírito de seu pai com a tua irmã.	José Dejalma Dezotti
Eum ualde etiam tuae litterae excitarunt.	Tua carta também o animou muito.	José Dejalma Dezotti
Quid quaeris? Confido rem ut uolumus esse.	Que queres? Confio que a coisa está como queremos.	José Dejalma Dezotti
Bis ad te antea scripsi de re mea familiari, si modo tibi redditae litterae sunt, Graece ἐν αἰνιγμοῖς.	Escrevi antes duas vezes sobre um assunto meu privado em grego, *em enigmas*, se é que as cartas te foram entregues.	José Dejalma Dezotti
Scilicet nihil est mouendum;	Evidentemente nada deve ser mexido;	José Dejalma Dezotti
sed tamen ἀφελῶς percontando de nominibus Milonis et ut expediat ut mihi receperit hortando aliquid aut proficies aut certe perspicies.	mas perguntando *simplesmente* sobre os títulos de Milão e exortando-o a que desembarace como me prometu, conseguirás algo ou, ao menos, averiguarás.	José Dejalma Dezotti
**2** Ego Laodiceae quaestorem Mescinium exspectare iussi, ut confectas rationes lege Iulia apud duas ciuitates possim relinquere.	**2** Eu ordenei que o questor Mescínio esperasse em Laodicéia, para que eu possa deixar terminadas as contas, segundo a lei Júlia, nas duas cidades.	José Dejalma Dezotti
Rhodum uolo puerorum causa, inde quam primum Athenas, etsi etesiae ualde reflant;	Quero ir para Rodes por causa dos meninos, de lá o quanto antes para Atenas, ainda que os ventos etésios soprem fortemente contra;	José Dejalma Dezotti
sed plane uolo his magistratibus, quorum uoluntatem in supplicatione sum expertus.	mas claramente quero isso com esses magistrados, cuja boa vontade constatei nas preces públicas.	José Dejalma Dezotti
Tu tamen mitte, quaeso, mihi obuiam litteras num quid putes rei publicae nomine tardandum esse nobis.	Tu, contudo, manda, peço-te, uma carta ao meu encontro, se por acaso julgas que em nome da república eu devo retardar-me.	José Dejalma Dezotti
Tiro ad te dedisset litteras, nisi eum grauiter aegrum Issi reliquissem;	Tirão teria entregado uma carta a ti, se eu não o tivesse deixado em Isso gravemente doente;	José Dejalma Dezotti
sed nuntiant melius esse.	mas me anunciam que está melhor.	José Dejalma Dezotti
Ego tamen angor;	Eu, contudo, me angustio;	José Dejalma Dezotti
nihil enim illo adulescente castius, nihil diligentius.	pois não há mais puro, nada mais diligente do que aquele jovem.	José Dejalma Dezotti
		José Dejalma Dezotti
**8**	**8**	José Dejalma Dezotti
Cicero Attico sal.	Cícero saúda Ático.	José Dejalma Dezotti
**1** Cum instituissem ad te scribere calamumque sumpsissem, Batonius e naui recta ad me uenit domum Ephesi et epistulam tuam reddidit II Kal. Oct.	**1** Quando eu tinha decidido te escrever e tinha pegado o cálamo, chegou Batônio diretamente do navio até minha casa em Éfeso e me entregou tua carta do segundo dia antes das calendas de outubro \[30 de setembro\]	José Dejalma Dezotti
Laetatus sum felicitate nauigationis tuae, opportunitate Piliae, etiam hercule sermone eiusdem de coniugio Tulliae meae.	Alegrei-me com felicidade de tua travessia, com o oportuno encontro com Pília, e também, por hércules, com a fala dela sobre o casamento de minha Túlia.	José Dejalma Dezotti
**2** Batonius autem meros terrores ad me attulit Caesarianos, cum Lepta etiam plura locutus est, spero falsa sed certe horribilia:	**2** Batônio, porém, me trouxe verdadeiros terrores cesarianos, falou com Lepta ainda mais coisas, espero que falsas, mas certamente terríveis:	José Dejalma Dezotti
exercitum nullo modo dimissurum, cum illo praetores designatos tris, Cassium tribunum pl., Lentulum consulem facere, Pompeio in animo esse urbem relinquere.	que ele não vai de modo algum dispensar o exército, que estão com ele três pretores designados, o tribuno da plebe Cássio e o cônsul Lêntulo, que Pompeu tem em mente abandonar a cidade.	José Dejalma Dezotti
**3** Sed heus tu, num quid moleste fers de illo qui se solet anteferre patruo sororis tuae fili?	**3** Mas olha, por acaso não estás indignado a respeito daquele que costuma se antepor ao tio do filho de tua irmã?	José Dejalma Dezotti
At a quibus uictus\!	E por quem é vencido\!	José Dejalma Dezotti
**4** Sed ad rem.	**4** Mas vamos ao assuto.	José Dejalma Dezotti
Nos etesiae uehementissimi tardarunt;	Violentíssimos ventos etésios nos retardaram;	José Dejalma Dezotti
detraxit XX ipsos dies etiam aphractus Rhodi.	o barco descoberto me fez perder 20 dias exatos em Rodes.	José Dejalma Dezotti
Kal. Oct. Epheso conscendentes hanc epistulam dedimus L. Tarquitio simul e portu egredienti sed expeditius nauiganti.	Nas calendas de outubro, embarcando em Éfeso, entregamos esta carta a Lúcio Tarquício, saindo do porto ao mesmo tempo, mas navegando mais rapidamente.	José Dejalma Dezotti
Nos Rhodiorum aphractis ceterisque longis nauibus tranquillitates aucupaturi eramus;	Nós, com os barcos descobertos dos ródios e com as demais naus de forma longa, estávamos à espreita de bonança;	José Dejalma Dezotti
ita tamen properabamus ut non posset magis.	contudo, nos apressávamos de tal modo que mais não era possível.	José Dejalma Dezotti
**5** De raudusculo Puteolano gratum.	**5** Quanto à dividazinha da chácara de Putéolos, agradecido.	José Dejalma Dezotti
Nunc uelim dispicias res Romanas, uideas quid nobis de triumpho cogitandum putes, ad quem amici me uocant.	Agora eu queria que observes os assuntos romanos, que vejas o que achas que devemos pensar a respeito do triunfo ao qual meus amigos convidam.	José Dejalma Dezotti
Ego, nisi Bibulus, qui dum unus hostis in Syria fuit pedem porta non plus extulit quam consul domo sua, adniteretur de triumpho, aequo essem animo;	Eu, se Bíbulo, que, enquanto houve um único inimigo na Síria, não pôs o pé fora da porta, quando cônsul, fora de sua casa, não se esforçasse por seu triunfo, eu estaria tranquilo;	José Dejalma Dezotti
nunc uero “αἰσχρὸν σιωπᾶν”.	mas agora “*é uma vergonha calar*”	José Dejalma Dezotti
Sed explora rem totam, ut quo die congressi erimus consilium capere possimus.	Mas examina a coisa toda, para que, no dia em que nos reunirmos, possamos tomar uma decisão.	José Dejalma Dezotti
Sat multa, qui et properarem et ei litteras darem qui aut mecum aut paulo ante uenturus esset.	Isso é suficiente, porque tenho pressa e entrego esta carta a alguém que vai chegar ou junto comigo ou um pouco antes.	José Dejalma Dezotti
Cicero tibi plurimam salutem dicit, tu dices utriusque nostrum uerbis et Piliae tuae et filiae.	Cícero te manda muita saúde, tu a mandarás da parte de nós dois tanto à tua Pília como à tua filha.	José Dejalma Dezotti
		José Dejalma Dezotti
**9**	**9**	José Dejalma Dezotti
Cicero Attico sal.	Cícero saúda Ático.	José Dejalma Dezotti
**1** In Piraeea cum exissem prid. Id. Oct., accepi ab Acasto seruo meo statim tuas litteras.	**1** Assim que desembarquei no Pireu, na véspera dos idos de outubro \[14 de outubro\], recebi de imediato de meu escravo Acasto a tua carta.	José Dejalma Dezotti
Quas quidem cum exspectassem iam diu, admiratus sum, ut uidi obsignatam epistulam, breuitatem eius, ut aperui, rursus σύγχυσιν litterularum, quae solent tuae compositissimae et clarissimae esse;	Como, na verdade, eu já a esperasse há muito tempo, fiquei admirado quando vi a carta ainda fechada, a brevidade dela, quando abri, igualmente a *irregularidade* de suas letrinhas e as tuas costumam ser muito cuidadas e muito claras	José Dejalma Dezotti
ac, ne multa, cognoui ex eo quod ita scripseras te Romam uenisse a. d. XII Kal. Oct. cum febri.	e, para não me alongar, pelo fato de teres escrito assim, soube que tinhas chegado a Roma no décimo segundo dia antes das calendas de outubro \[19 de setembro\] com febre.	José Dejalma Dezotti
Percussus uehementer, nec magis quam debui, statim quaero ex Acasto.	Fortemente afetado, não mais do que devia, pergunto logo em seguida a Acasto.	José Dejalma Dezotti
Ille et tibi et sibi uisum et ita se domi ex tuis audisse ut nihil esset incommodi;	Ele \[disse\] que a ti e ele próprio pareceu e assim ouviu dos teus em casa que não era nada preocupante.	José Dejalma Dezotti
id uidebatur adprobare quod erat in extremo, febriculam tum te habentem scripsisse.	Parecia aprovar isso o que estava no fim, que escreveste então tendo uma febrícula.	José Dejalma Dezotti
Sed te amaui tamen admiratusque sum quod nihilo minus ad me tua manu scripsisses.	Contudo apreciei e fiquei contente por teres mesmo assim me escrito com tua própria mão.	José Dejalma Dezotti
Qua re de hoc satis;	Por isso basta disso;	José Dejalma Dezotti
spero enim, quae tua prudentia et temperantia est, et hercule, ut me iubet Acastus, confido te iam ut uolumus ualere.	pois espero, o que é tua prudência e moderação, e, por hércules, conforme me aconselha Acasto, confio que logo estarás bom como desejamos.	José Dejalma Dezotti
**2** A Turranio te accepisse meas litteras gaudeo.	**2** Fico contente que tenhas recebido minha carta das mãos de Turrânio.	José Dejalma Dezotti
παραφύλαξον, si me amas, τὴν τοῦ φυρατοῦ φιλοτιμίαν·αὐτίκα γὰρ	(...) se me amas, (...)	José Dejalma Dezotti
hanc, quae mehercule mihi magno dolori est (dilexi enim hominem), procura, quantulacumque est, Precianam hereditatem;	cuida da herança de Precio, por perquena que seja, a qual, por hércules, me causa grande dor (pois eu estimei o homem);	José Dejalma Dezotti
prorsus ille ne attingat.	que ele não a toque.	José Dejalma Dezotti
Dices nummos mihi opus esse ad apparatum triumphi;	Dirás que tenho necessidade de dinheiro para o aparato do triunfo;	José Dejalma Dezotti
in quo, ut praecipis, nec me κενὸν in expetendo cognosces nec ἄτυφον in abiciendo.	nele, de acordo com teus preceitos, não me reconhecerás como *vaidoso* ao solicitá-lo nem *modesto* ao rechaçá-lo.	José Dejalma Dezotti
**3** Intellexi ex tuis litteris te ex Turranio audisse a me prouinciam fratri traditam.	**3** Entendi por tua carta que ouviste de Turrânio que a província foi entregue por mim a meu irmão.	José Dejalma Dezotti
Adeon ego non perspexeram prudentiam litterarum tuarum?	A tal ponto eu não ia notar a prudência de tua carta?	José Dejalma Dezotti
ἐπέχειν te scribebas;	(...) escrevias;	José Dejalma Dezotti
quid erat dubitatione dignum, si esset quicquam cur placeret fratrem et talem fratrem relinqui?	o que era digno de dúvida, se havia por que agradava que um irmão e um irmão como o meu fosse deixado no cargo?	José Dejalma Dezotti
ἀθέτησις ista mihi tua, non ἐποχὴ uidebatur.		José Dejalma Dezotti
Monebas de Q. Cicerone puero ut eum quidem neutiquam relinquerem:	Quanto ao menino Quinto Cícero me aconselhas que eu não o deixe de jeito nenhum:	José Dejalma Dezotti
“τοὐμὸν ὄνειρον ἐμοί.”	(...)	José Dejalma Dezotti
Eadem omnia quasi collocuti essemus uidimus.	Vimos as mesmas coisas como se tivéssemos conversado.	José Dejalma Dezotti
Non fuit faciendum aliter, meque ἐπιχρονία ἐποχὴ tua dubitatione liberauit.	Não se devia fazer diferente, e tua (...) me livrou da dúvida.	José Dejalma Dezotti
Sed puto te accepisse de hac re epistulam scriptam accuratius.	Mas acho que recebeste uma carta sobre esse assunto escrita mais caprichadamente.	José Dejalma Dezotti
**4** Ego tabellarios postero die ad uos eram missurus;	**4** Eu vou mandar carteiros para vós amanhã.	José Dejalma Dezotti
quos puto ante uenturos quam nostrum Saufeium, sed eum sine meis litteris ad te uenire uix rectum erat.	os quais eu acho que chegarão antes que o nosso Saufeio, mas era pouco correto que ele chegasse até ti sem minha carta.	José Dejalma Dezotti
**5** Tu mihi, ut polliceris, de Tulliola mea, id est de Dolabella, perscribes, de re publica, quam prouideo in summis periculis, de censoribus, maximeque de signis, tabulis quid fiat, referaturne.	5 Tu me escreverás detalhadamente, como prometeste, sobre minha Tuliazinha, isto é, sobre Dolabela, sobre a república, que prevejo em extremos perigos, sobre os censores e principalmente sobre as estátuas, quadros, o que acontece, o que se submete à deliberação.	José Dejalma Dezotti
Id. Oct. has dedi litteras, quo die, ut scribis, Caesar Placentiam legiones IIII.	Entreguei esta carta nos idos de outubro \[15 de outubro\], o dia em que, conforme escreves, César leva quatro legiões à Placência.	José Dejalma Dezotti
Quaeso, quid nobis futurum est?	Pergunto, o que será de nós?	José Dejalma Dezotti
In arce Athenis statio mea nunc placet.	Meu alojamento na cidadela em Atenas agora me agrada.	José Dejalma Dezotti
		José Dejalma Dezotti
