latintext	translation	translator
Marcus Tullius Cicero Epistulae ad Atticum – Liber VII	Cícero Cartas a Ático – Livro 7	José Dejalma Dezotti
-----	-----	José Dejalma Dezotti
TRADUÇÃO: **José Dejalma Dezotti**		José Dejalma Dezotti
		José Dejalma Dezotti
**1**	**1**	José Dejalma Dezotti
Cicero Attico sal.	Cícero saúda Ático.	José Dejalma Dezotti
**1** Dederam equidem L. Saufeio litteras et dederam ad te unum, quod, cum non esset temporis mihi ad scribendum satis, tamen hominem tibi tam familiarem sine meis litteris ad te uenire nolebam;	**1** Dei a Lúcio Saufeio uma carta e a dei só para ti, porque, embora eu não tivesse tempo suficiente para escrever, não queria, contudo, que uma pessoa tão amiga tua fosse até ti sem uma carta minha;	José Dejalma Dezotti
sed, ut philosophi ambulant, has tibi redditum iri putabam prius.	mas, como os filósofos vagueiam, julgo que esta te será entregue antes.	José Dejalma Dezotti
Sin iam illas accepisti, scis me Athenas uenisse prid. Id. Oct., e naui egressum in Piraeum tuas ab Acasto nostro litteras accepisse, conturbatum quod cum febre Romam uenisses bono tamen animo esse coepisse quod Acastus ea quae uellem de adleuato corpore tuo nuntiaret, cohorruisse autem in eo quod tuae litterae de legionibus Caesaris adferrent;	Se já recebeste aquela, sabes que cheguei em Atenas na véspera dos idos de outubro \[14 de outubro\], que, depois de sair do navio no Pireu, recebi do nosso querido Acasto a tua carta, alarmado porque tinhas chegado em Roma com febre, mas que passei a ficar tranquilo porque Acasto me informou o que eu desejava a respeito da melhora de teu corpo, que também tive calafrios em relação àquilo que tua carta trouxe acerca das legiões de César;	José Dejalma Dezotti
et egisse tecum ut uideres ne quid φιλοτιμία eius quem nosti nobis noceret;	e que tratei contigo para que cuidasses que não me prejudicasse a *ambição* daquele tu sabes quem;	José Dejalma Dezotti
et, de quo iam pridem ad te scripseram, Turranius autem secus tibi Brundisi dixerat (quod ex iis litteris cognoui quas a Xenone, optimo uiro, accepi), cur fratrem prouinciae non praefecissem exposui breuiter.	e, sobre aquilo que eu tinha escrito a ti já faz tempo, mas Turrânio tinha te dito com outro sentido em Brudísio (o que eu soube pela carta que recebi de Xenão, um homwm excelente), expliquei sucintamente por que não tinha posto meu irmão à frente da província.	José Dejalma Dezotti
Haec fere sunt in illa epistula.	São mais ou menos essas coisas naquela carta.	José Dejalma Dezotti
**2** Nunc audi reliqua:	**2** Agora ouve o resto:	José Dejalma Dezotti
Per fortunas, omnem tuum amorem quo me es amplexus omnemque tuam prudentiam, quam mehercule ego in omni genere iudico singularem, confer iam ad eam curam, ut de omni statu meo cogites.	Pelas fortunas, todo o teu afeto com que me abraçaste e toda a tua prudência, que, por hércules, eu considero excepcional em qualquer assunto, dedica agora a esta preocupação, que penses acerca de toda minha situação.	José Dejalma Dezotti
Videre enim mihi uideor tantam dimicationem, nisi idem deus qui nos melius quam optare auderemus Parthico bello liberauit, respexerit rem publicam—sed tantam quanta numquam fuit.	Pois pareço ver um tão grande combate, a não ser que o mesmo deus que nos livrou da guerra com os partos melhor do ousávamos desejar proteja a república \-- mas um combate tão grande quanto nunca houve.	José Dejalma Dezotti
Age, hoc malum mihi commune est cum omnibus;	Ora vamos, esta desgraça me é comum com todos;	José Dejalma Dezotti
nihil tibi mando ut de eo cogites, illud meum proprium πρόβλημα, quaeso, suscipe.	não te encarrego que penses nada em relação a isso, ocupa-te, peço, do meu próprio *problema*.	José Dejalma Dezotti
Videsne ut te auctore sim utrumque complexus \[Pompeium et Caesarem\]?	Não vês que, a teu conselho, eu abracei ambos \[Pompeu e César\]?	José Dejalma Dezotti
Ac uellem a principio te audisse amicissime monentem, “ἀλλ' ἐμὸν οὔποτε θυμὸν ἐνὶ στήθεσσιν ἔπειθες” sed aliquando tamen persuasisti ut alterum complecterer quia de me erat optime meritus, alterum quia tantum ualebat.	E eu queria ter te ouvido desde o princípio me aconselhando na maior amizade, “*nunca convenceste meu coração em meu peito*”, mas por fim me persuadiste a abraçar um por me obsequiar otimamente, o outro por ter taõ grande poder.	José Dejalma Dezotti
Feci igitur, itaque effeci omni obsequio ut neutri illorum quisquam esset me carior.	Fiz, portanto, e fiz com todo empenho de modo que para nenhum deles ninguém fosse mais estimado do que eu.	José Dejalma Dezotti
**3** Haec enim cogitabamus, nec mihi coniuncto cum Pompeio fore necesse peccare in re publica aliquando nec cum Pompeio sentienti pugnandum esse cum Caesare;	**3** Pois eu pensava isto: unido com Pompeu não haveria necessidade de às vezes cometer erro na república e estando de acordo com Pompeu não teria de lutar com César;	José Dejalma Dezotti
tanta erat illorum coniunctio.	tão grande era a união deles.	José Dejalma Dezotti
Nunc impendet, ut et tu ostendis et ego uideo, summa inter eos contentio.	Agora está iminente, como tu mostras e eu também vejo, uma grande tensão entre eles.	José Dejalma Dezotti
Me autem uterque numerat suum, nisi forte simulat alter.	Ambos me contam como seu partidário, a não ser que, por acaso, um esteja fingindo.	José Dejalma Dezotti
Nam Pompeius non dubitat;	Certamente Pompeu não tem dúvida;	José Dejalma Dezotti
uere enim iudicat ea quae de re publica nunc sentiat mihi ualde probari.	pois julga com razão que o que ele agora sente a respeito da república é totalmente aprovado por mim.	José Dejalma Dezotti
Vtriusque autem accepi eius modi litteras eodem tempore quo tuas ut neuter quemquam omnium pluris facere quam me uideretur.	Recebi dos dois cartas ao mesmo tempo que a tua de tal modo que a ninguém nenhum deles parece estimar mais do que a mim.	José Dejalma Dezotti
**4** Verum quid agam?	**4** Mas o que é que eu vou fazer?	José Dejalma Dezotti
Non quaero illa ultima (si enim castris res geretur, uideo cum altero uinci satius esse quam cum altero uincere), sed illa quae tum agentur cum uenero, ne ratio absentis habeatur, ut exercitum dimittat.	Não pergunto pela situação extrema (pois se a coisa for levada nos acampamentos, vejo que é melhor ser vencido com um do que vencer com o outro), mas o que será tratado quando eu tiver chegado, que não se tenha em conta ao ausente para que licencie o seu exército.	José Dejalma Dezotti
“Dic, M. Tulli.” Quid dicam?	“Diz, Marco Túlio.” O que vou dizer?	José Dejalma Dezotti
“Exspecta, amabo te, dum Atticum conueniam”?	“Espera, por favor, até que eu me encontre com Ático”?	José Dejalma Dezotti
Non est locus ad tergiuersandum.	Não há lugar para tergiversar.	José Dejalma Dezotti
Contra Caesarem?	Contra César?	José Dejalma Dezotti
“Vbi illae sunt densae dexterae?”;	“Onde estão aqueles apertos de mãos?”	José Dejalma Dezotti
Nam ut illi hoc liceret adiuui, rogatus ab ipso Rauennae de Caelio tribuno pl.	Pois favoreci a que isto lhe fosse permitido, solicitado por ele próprio em Ravena a respeito do tribuno da plebe Célio.	José Dejalma Dezotti
Ab ipso autem?	Por ele próprio?	José Dejalma Dezotti
Etiam a Gnaeo nostro in illo diuino tertio consulatu.	E também pelo nosso querido Cneu naquele divino terceiro consulado.	José Dejalma Dezotti
Aliter sensero?	Vou pensar de outro modo?	José Dejalma Dezotti
“αἰδέομαι” non Pompeium modo sed “Τρῶας καὶ Τρῳάδας”.	“*temo*” não só Pompeu, mas “*os troianos e as troianas*”.	José Dejalma Dezotti
“Πουλυδάμας μοι πρῶτος ἐλεγχείην καταθήσει”;	“*Polidamante será o primeiro a cobrir-me de ultrajes*”;	José Dejalma Dezotti
Quis? Tu ipse scilicet, laudator et factorum et scriptorum meorum.	Quem? Tu mesmo, sem dúvida, louvador tanto de meus feitos como de meus escritos,	José Dejalma Dezotti
**5** Hanc ergo plagam effugi per duos superiores Marcellorum consulatus cum est actum de prouincia Caesaris, nunc incido in discrimen ipsum.	**5** Portanto, eu evitei essa ferida durante os dois últimos consulados dos Marcelos, quando se tratou da província de César, agora caio no próprio dilema.	José Dejalma Dezotti
Itaque ut stultus primus suam sententiam dicat, mihi ualde placet de triumpho nos moliri aliquid, extra urbem esse cum iustissima causa.	E assim, que um idiota seja o primeiro a dizer sua opinião, a mim me agrada muito projetar algo acerca de meu triunfo, estar fora de cidade com o mais justificado motivo.	José Dejalma Dezotti
Tamen dabunt operam ut eliciant sententiam meam.	Contudo, trabalharão por arrancar minha opinião.	José Dejalma Dezotti
Ridebis hoc loco fortasse:	Vais rir neste ponto talvez:	José Dejalma Dezotti
quam uellem etiam nunc in prouincia morari\!	quanto eu queria permanecer ainda agora na província\!	José Dejalma Dezotti
Plane opus fuit, si hoc impendebat.	Realmente era preciso, se isso ameaçava.	José Dejalma Dezotti
Etsi nil miserius;	Embora nada fosse mais lamentável;	José Dejalma Dezotti
nam ὁδοῦ πάρεργον uolo te hoc scire:	Pois *de passagem* quero que tu saibas isto:	José Dejalma Dezotti
omnia illa prima quae etiam tu tuis litteris in caelum ferebas ἐπίτηκτα fuerunt.	todas aquelas coisas que tu punhas até mesmo no céu em tuas cartas foram *minudências*.	José Dejalma Dezotti
**6** Quam non est facilis uirtus\!	**6** Como não é fácil a virtude\!	José Dejalma Dezotti
Quam uero difficilis eius diuturna simulatio\!	Quão realmente difícil o seu fingimento por muito tempo\!	José Dejalma Dezotti
Cum enim hoc rectum et gloriosum putarem, ex annuo sumptu qui mihi decretus esset me C. Coelio quaestori relinquere annuum, referre in aerarium ad HS M, ingemuit nostra cohors, omne illud putans distribui sibi oportere, ut ego amicior inuenirer Phrygum et Cilicum aerariis quam nostro.	Pois como eu julgasse correto e glorioso deixar do orçamento anual que me havia sido decretado ao meu questor Caio Célio para um ano, devolver ao erário por volta de um milhão de sestércios, nossa coorte deplorou, achando que convinha que tudo aquilo fosse distribuído entre eles, na idéia de que eu me mostrava mais amigo dos erários dos frígios e cilícios do que do nosso.	José Dejalma Dezotti
Sed me non mouerunt;	Mas não me comoveram;	José Dejalma Dezotti
nam et mea laus apud me plurimum ualuit nec tamen quicquam honorifice in quemquam fieri potuit quod praetermiserim.	pois minha reputação valeu mais que tudo para mim e, ademais, não há nada que pôde ser feito em honra para alguém que eu não tenha deixado passa.	José Dejalma Dezotti
Sed haec fuerit, ut ait Thucydides, ἐκβολὴ λόγου non inutilis.	Mas isso foi, como diz Tucídides, uma *digressão* não inútil.	José Dejalma Dezotti
**7** Tu autem de nostro statu cogitabis:	**7** Tu, porém, pensarás a respeito de minha situação.	José Dejalma Dezotti
primum quo artificio tueamur beneuolentiam Caesaris, deinde de ipso triumpho,	primeiramente com que meio eu posso conservar a boa disposição de César, depois a respeito do próprio triunfo,	José Dejalma Dezotti
quem uideo, nisi rei publicae tempora impedient, εὐπόριστον.	que eu vejo, se as circunstâncias da república não impedirem, *em excelente situação*.	José Dejalma Dezotti
Iudico autem cum ex litteris amicorum tum ex supplicatione;	Julgo assim tanto pelas cartas dos amigos, como pela ação de graças pública;	José Dejalma Dezotti
quam qui non decreuit, plus decreuit quam si omnis decresset triumphos.	quem não a aprovou, aprovou mais do que se tivesse aprovado todos os triunfos.	José Dejalma Dezotti
Ei porro adsensus est unus familiaris meus, Fauonius, alter iratus, Hirrus.	Estiveram de acordo com ele um amigo meu, Favônio e um irritado comigo, Hirro.	José Dejalma Dezotti
Cato autem et scribendo adfuit et ad me de sententia sua iucundissimas litteras misit.	Catão, por sua vez, participou escrevendo e enviou a mim uma carta muito prazerosa acerca de sua sentença.	José Dejalma Dezotti
Sed tamen gratulans mihi Caesar de supplicatione triumphat de sententia Catonis, nec scribit quid ille sententiae dixerit sed tantum supplicationem eum mihi non decreuisse.	No entanto César, me felicitando a respeito da ação de graças, triunfa acerca da sentença de Catão, e não escreve que sentença aquele disse, mas somente que ele não aprovou a ação de graças para mim.	José Dejalma Dezotti
**8** Redeo ad Hirrum.	**8** Volto a Hirro.	José Dejalma Dezotti
Coeperas eum mihi placare:	Tinhas começado a reconciliá-lo comigo:	José Dejalma Dezotti
perfice.	termina.	José Dejalma Dezotti
Habes Scrofam, habes Silium.	Tens Escrofa, tens Sílio.	José Dejalma Dezotti
Ad eos ego etiam antea scripsi et iam ad ipsum Hirrum.	Eu mesmo antes escrevi a esses e agora ao próprio Hirro.	José Dejalma Dezotti
Locutus enim erat cum iis commode se potuisse impedire sed noluisse;	Pois ele tinha falado com eles que podia facilmente tê-lo impedido, mas não quis;	José Dejalma Dezotti
adsensum tantum esse Catoni, amicissimo meo, cum is honorificentissimam in me sententiam dixisset;	que tinha apenas estado de acordo com Catão, amicíssimo meu, quando este tinha dito uma sentença muitíssima honrosa para mim;	José Dejalma Dezotti
nec me ad se ullas litteras misisse, cum ad omnis mitterem.	que eu não tinha enviado nenhuma carta a ele, quando eu enviava a todos.	José Dejalma Dezotti
Verum dicebat;	Dizia a verdade;	José Dejalma Dezotti
ad eum enim solum et ad Crassipedem non scripseram.	pois somente a ele e a Crassípede eu não tinha escrito.	José Dejalma Dezotti
**9** Atque haec de rebus forensibus:	**9** Isso a respeito de assuntos forenses;	José Dejalma Dezotti
redeamus domum.	voltemos para casa.	José Dejalma Dezotti
Diiungere me ab illo uolo;	Quero me afastar dele;	José Dejalma Dezotti
merus est φυρατής, germanus Lartidius.	é um mero trapaceiro, um legítimo imitador de Ulisses.	José Dejalma Dezotti
“ἀλλὰ τὰ μὲν προτετύχθαι ἐάσομεν ἀχνύμενοί περ.”		José Dejalma Dezotti
Reliqua expediamus;	Resolvamos o restante;	José Dejalma Dezotti
hoc primum, quae accessit cura dolori meo—sed tamen hoc, quicquid est, Precianum cum iis rationibus quas ille meas tractat admisceri nolo.	primeiramente isto que acrescentou preocupação à minha dor \-- mas o de Précio, seja o que for, não quero que se misture com as minhas contas que aquele maneja.	José Dejalma Dezotti
Scripsi ad Terentiam, scripsi etiam ad ipsum, me quicquid posset nummorum ad apparatum sperati triumphi ad te redacturum.	Escrevi para Terência, escrevi até mesmo para ele próprio, que eu entregaria a ti tudo que fosse possível do dinheiro para o aparato do triunfo esperado.	José Dejalma Dezotti
Ita puto ἄμεμπτα fore;	Assim penso que será *sem reproche*;	José Dejalma Dezotti
uerum ut libebit.	mas como for do agrado.	José Dejalma Dezotti
Hanc quoque suscipe curam, quem ad modum expediamur;	Encarrega-te também deste cuidado, de como resolvemos;	José Dejalma Dezotti
id tu et ostendisti quibusdam litteris ex Epiro an Athenis datis et in eo ego te adiuuabo.	tu mostraste isso numa certa carta enviada de Epiro ou de Atenas e nisso eu te ajudarei.	José Dejalma Dezotti
		José Dejalma Dezotti
**2**	**2**	José Dejalma Dezotti
Cicero Attico sal.	Cícero saúda Ático.	José Dejalma Dezotti
**1** Brundisium uenimus VII Kal. Dec. usi tua felicitate nauigandi;	**1** Chegamos a Brundísio no sétimo dia antes das calendas de dezembro \[25 de novembro\], tendo desfrutado da tua felicidade de navegar;	José Dejalma Dezotti
ita belle nobis “flauit ab Epiro lenissimus Onchesmites” (hunc σπονδειάζοντα si cui uoles τῶν νεωτέρων pro tuo uendito).	tão lindamente nos “soprou de Epiro um suavíssimo Onquesmita” (este *espondaico*, vende-o como teu, se quiseres, a qualquer *dos neotéricos*).	José Dejalma Dezotti
**2** Valetudo tua me ualde conturbat;	**2** Tua saúde está me preocupando muito;	José Dejalma Dezotti
significant enim tuae litterae te prorsus laborare.	pois tua carta indica que estás realmente sofrendo.	José Dejalma Dezotti
Ego autem, cum sciam quam sis fortis, uehementius esse quiddam suspicor quod te cogat cedere et prope modum infringat.	Eu porém, como sei quão forte és, suspeito que há algo mais sério que te obriga a ceder e quase te arrebenta.	José Dejalma Dezotti
Etsi alteram quartanam Pamphilus tuus mihi dixit decessisse et alteram leuiorem accedere.	Embora teu Pânfilo tenha me dito que uma quartã foi embora e chega outra mais leve.	José Dejalma Dezotti
Terentia uero, quae quidem eodem tempore ad portam Brundisinam uenit quo ego in portum mihique obuia in foro fuit, L. Pontium sibi in Trebulano dixisse narrabat etiam eam decessisse;	Terência, porém, que na verdade chegou à porta de Brundísio ao mesmo tempo em que eu cheguei no porto e foi ao meu encontro no foro, conta que Lúcio Pôntio lhe disse em Trebulano que também essa foi embora;	José Dejalma Dezotti
quod si ita est, quod maxime mehercule opto, gaudeo, idque spero tua prudentia et temperantia te consecutum.	e se isso é assim, o que, por hércules eu mais desejo, fico contente, e espero que tenha conseguido isso com tua prudência e moderação.	José Dejalma Dezotti
**3** Venio ad epistulas tuas;	**3** Venho agora às tuas cartas;	José Dejalma Dezotti
quas ego sescentas uno tempore accepi, aliam alia iucundiorem, quae quidem erant tua manu;	eu recebi seiscentas de uma vez só, uma mais prazerosa que a outra, que eram de tua própria mão;	José Dejalma Dezotti
nam Alexidis manum amabam quod tam prope accedebat ad similitudinem tuae, non amabam quod indicabat te non ualere.	com efeito, gosto muito da letra de Alexis, porque se aproxima muito em semelhança da tua, não gosto porque ela mostra que não estás bem de saúde.	José Dejalma Dezotti
Cuius quoniam mentio facta est, Tironem Patris aegrum reliqui, adulescentem doctum et diligentem, ut nosti, et adde, si quid uis, probum;	Já que se fez menção a ele, deixei Tirão doente em Patras, jovem instruído e diligente, como sabes, e acrescenta, se queres, honrado;	José Dejalma Dezotti
nihil uidi melius.	não vi nada melhor.	José Dejalma Dezotti
Itaque careo aegre et, quamquam uidebatur se non grauiter habere, tamen sum sollicitus maximamque spem habeo in M'. Curi diligentia, de qua ad me scripsit Tiro et multi nuntiarunt.	E assim lamentavelmente estou sem ele e, embora pareça não encontrar-se gravemente, mesmo assim estou preocupado e tenho a maior esperança no zelo de Mânio Cúrio, a respeito do qual Tirão me escreveu e muitos me informaram.	José Dejalma Dezotti
Curius autem ipse sensit quam tu uelles se a me diligi, et eo sum admodum delectatus.	O próprio Cúrio, por sua vez, notou o quanto tu queres que ele seja estimado por mim, e eu estou muitíssimo satisfeito com ele.	José Dejalma Dezotti
Et mehercule est quem facile diligas;	E, por hércules, é alguém a quem estimas facilmente;	José Dejalma Dezotti
αὐτόχθων in homine urbanitas est.	há no homem uma educação *genuína*.	José Dejalma Dezotti
Eius testamentum deporto trium Ciceronum signis obsignatum cohortisque praetoriae;	Levo o seu testamento assinalado com os selos dos três Cíceros e da coorte pretoriana;	José Dejalma Dezotti
fecit palam te ex libella, me ex terruncio.	Perante testemunhas a ti ele legou um décimo, a mim um quadragésimo.	José Dejalma Dezotti
In Actio Corcyrae Alexio me opipare muneratus est.	Em Áccio, em Cocira, Alexião me presenteou lautamente.	José Dejalma Dezotti
Q. Ciceroni obsisti non potuit quo minus Thyamim uideret.	Não se pôde impedir que Quinto Cícero visse o Rio Tiâmide.	José Dejalma Dezotti
**4** Filiola tua te delectari laetor et probari tibi φυσικὴν esse τὴν στοργὴν τὴν πρὸς τὰ τέκνα.	**4** Me alegro que te deleites com tua filhinha e que seja aprovado por ti que é *natural o afeto para com os filhos*.	José Dejalma Dezotti
Etenim si hoc non est, nulla potest homini esse ad hominem naturae adiunctio;	Com efeito, se não é assim, não pode haver nenhum laço natural de um homem para com outro homem;	José Dejalma Dezotti
qua sublata uitae societas tollitur.	e suprimido este, suprime-se a vida social.	José Dejalma Dezotti
“Bene eueniat\!” inquit Carneades, spurce, sed tamen prudentius quam Lucius noster et Patron, qui, cum omnia ad se referant nec quicquam alterius causa fieri putent et cum ea re bonum uirum esse oportere dicant ne malum habeat, non quod id natura rectum sit, non intellegunt se de callido homine loqui, non de bono uiro.	“Que ocorra bem\!” diz Carnéades, porcamente, mas mesmo assim com mais sabedoria do que o nosso Lúcio e Patrão, os quais, quando referem tudo a si mesmos e julgam que nada se faz por causa de outrem e quando dizem que convém ser o homem bom para não ter mal, não porque isso é o correto por natureza, não entendem que falam de um homem astuto, não de um homem bom.	José Dejalma Dezotti
Sed haec, opinor, sunt in iis libris quos tu laudando animos mihi addidisti.	Mas essas coisas, acho eu, estão nos livros com que tu me encorajaste, louvando-os.	José Dejalma Dezotti
**5** Redeo ad rem.	**5** Volto ao assunto.	José Dejalma Dezotti
Quo modo exspectabam epistulam quam Philoxeno dedisses\!	Como eu esperava a carta que tinhas entregado a Filoxeno\!	José Dejalma Dezotti
Scripseras enim in ea esse de sermone Pompei Neapolitano.	Pois tinhas escrito que havia nela informação sobre a conversa de Pompeu em Nápolis.	José Dejalma Dezotti
Eam mihi Patron Brundisi reddidit;	Patrão a entregou para mim em Brundísio;	José Dejalma Dezotti
Corcyrae, ut opinor, acceperat.	Conforme acho, ele a tinha recebido em Corcira.	José Dejalma Dezotti
Nihil potuit esse iucundius;	Nada pôde ser mais prazeroso;	José Dejalma Dezotti
erat enim de re publica, de opinione quam is uir haberet integritatis meae, de beneuolentia quam ostendit eo sermone quem habuit de triumpho.	pois era sobre a república, sobre a opinião que esse homem tinha sobre minha integridade, sobre a boa vontade que mostrou na conversa que teve sobre o meu triunfo.	José Dejalma Dezotti
Sed tamen hoc iucundissimum, quod intellexi te ad eum uenisse ut eius animum erga me perspiceres;	Mas, no entanto, o mais prazeroso é que entendi que tu foste até ele para observar bem sua disposição para comigo;	José Dejalma Dezotti
hoc mihi, inquam, accidit iucundissimum.	isso, eu repito, me resultou muito prazeroso.	José Dejalma Dezotti
**6** De triumpho autem nulla me cupiditas umquam tenuit ante Bibuli impudentissimas litteras quas amplissima supplicatio consecuta est.	**6** A respeito do meu triunfo, porém, nunca nenhuma ambição me dominou antes da desavergonhadíssima carta de Bíbulo a que se seguiu uma amplíssima ação de graças.	José Dejalma Dezotti
A quo si ea gesta essent quae scripsit, gauderem et honori fauerem;		José Dejalma Dezotti
nunc illum, qui pedem porta quoad hostis cis Euphratem fuit non extulerit, honore augeri, me, in cuius exercitu spem illius exercitus habuit, idem non adsequi dedecus est nostrum \- nostrum, inquam, te coniungens.		José Dejalma Dezotti
Itaque omnia experiar et, ut spero, adsequar.		José Dejalma Dezotti
Quod si tu ualeres, iam mihi quaedam explorata essent;		José Dejalma Dezotti
sed, ut spero, ualebis.		José Dejalma Dezotti
**7** De raudusculo Numeriano multum te amo.		José Dejalma Dezotti
Hortensius quid egerit aueo scire, Cato quid agat;		José Dejalma Dezotti
qui quidem in me turpiter fuit maleuolus.		José Dejalma Dezotti
Dedit integritatis, iustitiae, clementiae, fidei mihi testimonium, quod non quaerebam;		José Dejalma Dezotti
quod postulabam negauit.		José Dejalma Dezotti
\[Id\] itaque Caesar iis litteris quibus mihi gratulatur et omnia pollicetur quo modo exsultat Catonis in me ingratissimi iniuria\!		José Dejalma Dezotti
At hic idem Bibulo dierum XX.		José Dejalma Dezotti
Ignosce mihi: non possum haec ferre nec feram.		José Dejalma Dezotti
**8** Cupio ad omnis tuas epistulas, sed nihil necesse est;		José Dejalma Dezotti
iam enim te uidebo.		José Dejalma Dezotti
Illud tamen de Chrysippo (nam de altero illo minus sum admiratus, operario homine;		José Dejalma Dezotti
sed tamen ne illo quidem quicquam improbius) \- Chrysippum uero, quem ego propter		José Dejalma Dezotti
litterularum nescio quid libenter uidi, in honore habui, discedere a puero insciente me\!		José Dejalma Dezotti
Mitto alia quae audio multa, mitto furta;		José Dejalma Dezotti
fugam non fero, qua mihi nihil uisum est sceleratius.		José Dejalma Dezotti
Itaque usurpaui uetus illud Drusi, ut ferunt, praetoris in eo qui eadem liber non iuraret, me istos liberos non addixisse, praesertim cum adesset nemo a quo recte uindicarentur.		José Dejalma Dezotti
Id tu, ut uidebitur, ita accipies;		José Dejalma Dezotti
ego tibi adsentiar.		José Dejalma Dezotti
Vni tuae disertissimae epistulae non rescripsi, in qua est de periculis rei publicae.		José Dejalma Dezotti
Quid rescriberem?		José Dejalma Dezotti
Valde eram perturbatus.		José Dejalma Dezotti
Sed ut nihil magno opere metuam Parthi faciunt, qui repente Bibulum semiuiuum reliquerunt.		José Dejalma Dezotti
		José Dejalma Dezotti
**3**	**3**	José Dejalma Dezotti
Cicero Attico sal.	Cícero saúda Ático.	José Dejalma Dezotti
**1** A. d. VIII Id. Dec. Aeculanum ueni et ibi tuas litteras legi quas Philotimus mihi reddidit;		José Dejalma Dezotti
e quibus hanc primo aspectu uoluptatem cepi, quod erant a te ipso scriptae, deinde earum accuratissima diligentia sum mirum in modum delectatus.		José Dejalma Dezotti
Ac primum illud in quo te Dicaearcho adsentiri negas:		José Dejalma Dezotti
etsi cupidissime expetitum a me est et te adprobante ne diutius anno in prouincia essem, tamen non est nostra contentione perfectum.		José Dejalma Dezotti
Sic enim scito, uerbum in senatu factum esse numquam de ullo nostrum qui prouincias obtinuimus quo in iis diutius quam ex senatus consulto maneremus, ut iam ne istius quidem rei culpam sustineam, quod minus diu fuerim in prouincia quam fortasse fuerit utile.		José Dejalma Dezotti
**2** Sed “quid si hoc melius?” saepe opportune dici uidetur, ut in hoc ipso.		José Dejalma Dezotti
Siue enim ad concordiam res adduci potest siue ad bonorum uictoriam, utriusuis rei me aut adiutorem uelim esse aut certe non expertem;		José Dejalma Dezotti
sin uincuntur boni, ubicumque essem, una cum iis uictus essem.		José Dejalma Dezotti
Qua re celeritas nostri reditus ἀμεταμέλητος debet esse.		José Dejalma Dezotti
Quod si ista nobis cogitatio de triumpho iniecta non esset, quam tu quoque adprobas, ne tu haud multum requireres illum uirum qui in sexto libro informatus est.		José Dejalma Dezotti
Quid enim tibi faciam, qui illos libros deuorasti?		José Dejalma Dezotti
Quin nunc ipsum non dubitabo rem tantam abicere, si id erit rectius.		José Dejalma Dezotti
Vtrumque uero simul agi non potest, et de triumpho ambitiose et de re publica libere.		José Dejalma Dezotti
Sed ne dubitaris quin, quod honestius, id mihi futurum sit antiquius.		José Dejalma Dezotti
**3** Nam quod putas utilius esse, uel mihi quod tutius sit uel etiam ut rei publicae prodesse possim, me esse cum imperio, id coram considerabimus quale sit;		José Dejalma Dezotti
habet enim res deliberationem, etsi ex parte magna tibi adsentior.		José Dejalma Dezotti
De animo autem meo erga rem publicam bene facis quod non dubitas, et illud probe iudicas, nequaquam satis pro meis officiis, pro ipsius in alios effusione illum in me liberalem fuisse, eiusque rei causam uere explicas;		José Dejalma Dezotti
†et eis† quae de Fabio Caninioque acta scribis ualde consentiunt.		José Dejalma Dezotti
Quae si secus essent totumque se ille in me profudisset, tamen illa quam scribis custos urbis me praeclarae inscriptionis memorem esse cogeret nec mihi concederet ut imitarer Vulcatium aut Seruium, quibus tu es contentus, sed aliquid nos uellet nobis dignum et sentire et defendere;		José Dejalma Dezotti
quod quidem agerem, si liceret, alio modo ac nunc agendum est.		José Dejalma Dezotti
**4** De sua potentia dimicant homines hoc tempore periculo ciuitatis.		José Dejalma Dezotti
Nam si res publica defenditur, cur ea consule isto ipso defensa non est?		José Dejalma Dezotti
Cur ego, in cuius causa rei publicae salus consistebat, defensus postero anno non sum?		José Dejalma Dezotti
Cur imperium illi aut cur illo modo prorogatum est?		José Dejalma Dezotti
Cur tanto opere pugnatum ut de eius absentis ratione habenda decem tribuni pl. ferrent?		José Dejalma Dezotti
His ille rebus ita conualuit ut nunc in uno ciui spes ad resistendum sit;		José Dejalma Dezotti
qui mallem tantas ei uiris non dedisset quam nunc tam ualenti resisteret.		José Dejalma Dezotti
**5** Sed quoniam res eo deducta est, non quaeram, ut scribis, “ποῦ σκάφος τὸ τῶν ᾿Ατρειδῶν;”:		José Dejalma Dezotti
mihi σκάφος unum erit quod a Pompeio gubernabitur.		José Dejalma Dezotti
Illud ipsum quod ais, “Quid fiet cum erit dictum ‘dic, M. Tulli?’”:		José Dejalma Dezotti
σύντομα, “Cn. Pompeio adsentior”.		José Dejalma Dezotti
Ipsum tamen Pompeium separatim ad concordiam hortabor;		José Dejalma Dezotti
sic enim sentio, maximo in periculo rem esse.		José Dejalma Dezotti
Vos scilicet plura, qui in urbe estis;		José Dejalma Dezotti
uerum tamen haec uideo, cum homine audacissimo paratissimoque negotium esse, omnis damnatos, omnis ignominia adfectos, omnis damnatione ignominiaque dignos illac facere, omnem fere iuuentutem, omnem illam urbanam ac perditam plebem, tribunos ualentis addito Q. Cassio, omnis qui aere alieno premantur, quos pluris esse intellego quam putaram (causam solum illa causa non habet, ceteris rebus abundat);		José Dejalma Dezotti
hic omnia facere omnis ne armis decernatur, quorum exitus semper incerti, nunc uero etiam in alteram partem magis timendi.		José Dejalma Dezotti
Bibulus de prouincia decessit, Veientonem praefecit;		José Dejalma Dezotti
in decedendo erit, ut audio, tardior.		José Dejalma Dezotti
Quem cum ornauit Cato declarauit iis se solis \[non\] inuidere quibus nihil aut non multum ad dignitatem posset accedere.		José Dejalma Dezotti
**6** Nunc uenio ad priuata;		José Dejalma Dezotti
fere enim respondi tuis litteris de re publica et iis quas in suburbano et iis quas postea scripsisti.		José Dejalma Dezotti
Ad priuata uenio.		José Dejalma Dezotti
Vnum etiam, de Caelio:		José Dejalma Dezotti
tantum abest ut meam ille sententiam moueat ut ualde ego ipsi quod de sua sententia decesserit paenitendum putem.		José Dejalma Dezotti
Sed quid est quod ei uici Luccei sint addicti?		José Dejalma Dezotti
Hoc te praetermisisse miror.		José Dejalma Dezotti
**7** De Philotimo, faciam equidem ut mones.		José Dejalma Dezotti
Sed ego †mihi† ab illo hoc tempore non rationes exspectabam quas tibi edidit, uerum id reliquum quod ipse in Tusculano me referre in commentarium mea manu uoluit quodque idem in Asia mihi sua manu scriptum dedit.		José Dejalma Dezotti
Id si praestaret, quantum mihi aeris alieni esse tibi edidit, tantum et plus etiam mihi ipse deberet.		José Dejalma Dezotti
Sed in hoc genere, si modo per rem publicam licebit, non accusabimur posthac;		José Dejalma Dezotti
neque hercule antea neglegentes fuimus sed et amicorum et publicorum negotiorum multitudine occupati.		José Dejalma Dezotti
Ergo utemur, ut polliceris, et opera et consilio tuo, nec tibi erimus, ut spero, in eo molesti.		José Dejalma Dezotti
**8** De serpirastris cohortis meae, nihil est quod doleas;		José Dejalma Dezotti
ipsi enim se collegerunt admiratione \[in te\] integritatis meae.		José Dejalma Dezotti
Sed me mouerat nemo magis quam is quem tu minime putas.		José Dejalma Dezotti
Idem et initio fuerat et nunc est egregius;		José Dejalma Dezotti
sed in ipsa decessione significauit sperasse se aliquid et id quod animum induxerat paulisper non tenuit, sed cito ad se rediit meisque honorificentissimis erga se officiis uictus pluris ea duxit quam omnem pecuniam.		José Dejalma Dezotti
**9** Ego a Curio tabulas accepi, quas mecum porto.		José Dejalma Dezotti
Hortensi legata cognoui;		José Dejalma Dezotti
nunc aueo scire quid †hominis† sit et quarum rerum auctionem instituat;		José Dejalma Dezotti
nescio enim cur, cum portam Flumentanam Caelius occuparit, ego Puteolos non meos faciam.		José Dejalma Dezotti
**10** Venio ad “Piraeea”, in quo magis reprehendendus sum quod homo Romanus “Piraeea” scripserim, non “Piraeum” (sic enim omnes nostri locuti sunt), quam quod addiderim “in”;		José Dejalma Dezotti
non enim hoc ut oppido praeposui sed ut loco;		José Dejalma Dezotti
et tamen Dionysius noster et qui est nobiscum Nicias Cous non rebatur oppidum esse Piraeea.		José Dejalma Dezotti
Sed de re uidero.		José Dejalma Dezotti
Nostrum quidem si est peccatum, in eo est quod non ut de oppido locutus sum sed ut de loco, secutusque sum non dico Caecilium, “Mane ut ex portu in Piraeum” (malus enim auctor Latinitatis est), sed Terentium (cuius fabellae propter elegantiam sermonis putabantur a C. Laelio scribi), “Heri aliquot adulescentuli coiimus in Piraeum”;		José Dejalma Dezotti
Et idem, “Mercator hoc addebat, captam e Sunio”;		José Dejalma Dezotti
quod si δήμους oppida uolumus esse, tam est oppidum Sunium quam Piraeus.		José Dejalma Dezotti
Sed quoniam grammaticus es, si hoc mihi ζήτημα persolueris, magna me molestia liberaris.		José Dejalma Dezotti
**11** Ille mihi litteras blandas mittit;		José Dejalma Dezotti
facit idem pro eo Balbus.		José Dejalma Dezotti
Mihi certum est ab honestissima sententia digitum nusquam;		José Dejalma Dezotti
sed scis illi reliquum quantum sit.		José Dejalma Dezotti
Putasne igitur uerendum esse ne aut obiciat id nobis aliquis, si languidius, aut repetat, si fortius?		José Dejalma Dezotti
Quid ad haec reperis?		José Dejalma Dezotti
“Soluamus” inquis.		José Dejalma Dezotti
Age, a Caelio mutuabimur.		José Dejalma Dezotti
Hoc tu tamen consideres uelim.		José Dejalma Dezotti
Puto enim, in senatu si quando praeclare pro re publica dixero, Tartessium istum tuum mihi exeunti, “Iube sodes nummos curare”.		José Dejalma Dezotti
**12** Quid superest? Etiam:		José Dejalma Dezotti
gener est suauis mihi, Tulliae, Terentiae;		José Dejalma Dezotti
quantumuis uel ingeni uel humanitatis †satis†;		José Dejalma Dezotti
reliqua, quae nosti, ferenda.		José Dejalma Dezotti
scis enim quos †aperierimus†;		José Dejalma Dezotti
qui omnes, praeter eum de quo per te egimus, reum me facerent.		José Dejalma Dezotti
Ipsis enim expensum nemo ferret.		José Dejalma Dezotti
Sed haec coram;		José Dejalma Dezotti
nam multi sermonis sunt.		José Dejalma Dezotti
Tironis reficiendi spes est in M'. Curio, cui ego scripsi tibi eum gratissimum facturum.		José Dejalma Dezotti
Data V Id. Dec. a Pontio ex Trebulano.		José Dejalma Dezotti
		José Dejalma Dezotti
**4**	**4**	José Dejalma Dezotti
Cicero Attico sal.	Cícero saúda Ático.	José Dejalma Dezotti
**1** Dionysium flagrantem desiderio tui misi ad te, nec mehercule aequo animo, sed fuit concedendum.		José Dejalma Dezotti
Quem quidem cognoui cum doctum, quod mihi iam ante erat notum, tum sanctum, plenum offici, studiosum etiam meae laudis, frugi hominem, ac, ne libertinum laudare uidear, plane uirum bonum.		José Dejalma Dezotti
**2** Pompeium uidi IIII Id. Dec.;		José Dejalma Dezotti
fuimus una horas duas fortasse.		José Dejalma Dezotti
Magna laetitia mihi uisus est adfici meo aduentu;		José Dejalma Dezotti
de triumpho hortari, suscipere partis suas, monere ne ante in senatum accederem quam rem confecissem, ne dicendis sententiis aliquem tribunum alienarem.		José Dejalma Dezotti
Quid quaeris? In hoc officio sermone eius nihil potuit esse prolixius.		José Dejalma Dezotti
De re publica autem ita mecum locutus est quasi non dubium bellum haberemus:		José Dejalma Dezotti
nihil ad spem concordiae;		José Dejalma Dezotti
plane illum a se alienatum cum ante intellegeret, tum uero proxime iudicasse;		José Dejalma Dezotti
uenisse Hirtium a Caesare, qui esset illi familiarissimus;		José Dejalma Dezotti
ad se non accessisse et, cum ille a. d. VIII Id. Dec. uesperi uenisset, Balbus de tota re constituisset a. d. VII ad Scipionem ante lucem uenire, multa de nocte eum profectum esse ad Caesarem.		José Dejalma Dezotti
Hoc illi τεκμηριῶδες uidebatur esse alienationis.		José Dejalma Dezotti
**3** Quid multa? Nihil me aliud consolatur nisi quod illum, cui etiam inimici alterum consulatum, fortuna summam potentiam dederit, non arbitror fore tam amentem ut haec in discrimen adducat.		José Dejalma Dezotti
Quod si ruere coeperit, ne ego multa timeo quae non audeo scribere.		José Dejalma Dezotti
Sed ut nunc est, a. d. III Non. Ian. ad urbem cogito.		José Dejalma Dezotti
		José Dejalma Dezotti
**5**	**5**	José Dejalma Dezotti
Cicero Attico sal.	Cícero saúda Ático.	José Dejalma Dezotti
**1** Multas uno tempore accepi tuas, quae mihi, quamquam recentiora audiebam ex iis qui ad me ueniebant, tamen erant iucundae;		José Dejalma Dezotti
studium enim et beneuolentiam declarabant.		José Dejalma Dezotti
Valetudine tua moueor et Piliam in idem genus morbi delapsam curam tibi adferre maiorem sentio.		José Dejalma Dezotti
Date igitur operam ut ualeatis.		José Dejalma Dezotti
**2** De Tirone uideo tibi curae esse;		José Dejalma Dezotti
quem quidem ego, etsi mirabilis utilitates mihi praebet, cum ualet, in omni genere uel negotiorum uel studiorum meorum, tamen propter humanitatem et modestiam malo saluum quam propter usum meum.		José Dejalma Dezotti
**3** Philogenes mecum nihil umquam de †lusgenio† locutus est;		José Dejalma Dezotti
de ceteris rebus habes Dionysium.		José Dejalma Dezotti
Sororem tuam non uenisse in Arcanum miror.		José Dejalma Dezotti
De Chrysippo, meum consilium probari tibi non moleste fero.		José Dejalma Dezotti
Ego in Tusculanum nihil sane hoc tempore (deuium est τοῖς ἀπαντῶσιν et habet alia δύσχρηστα), sed de Formiano Tarracinam prid. Kal. Ian., inde Pomptinum †summam†, inde Albanum Pompei;		José Dejalma Dezotti
ita ad urbem III Non., natali meo.		José Dejalma Dezotti
**4** De re publica cottidie magis timeo.		José Dejalma Dezotti
Non enim boni, ut putantur, consentiunt.		José Dejalma Dezotti
Quos ego equites Romanos, quos senatores uidi, qui acerrime cum cetera tum hoc iter Pompei uituperarent\!		José Dejalma Dezotti
Pace opus est.		José Dejalma Dezotti
Ex uictoria cum multa mala tum certe tyrannus exsistet.		José Dejalma Dezotti
Sed haec prope diem coram.		José Dejalma Dezotti
Iam plane mihi deest quid ad te scribam;		José Dejalma Dezotti
nec enim de re publica, quod uterque nostrum scit eadem, et domestica nota sunt ambobus.		José Dejalma Dezotti
**5** Reliquum est iocari, si hic sinat;		José Dejalma Dezotti
nam ego is sum qui illi concedi putem utilius esse quod postulat quam signa conferri;		José Dejalma Dezotti
sero enim resistimus ei quem per annos decem aluimus contra nos.		José Dejalma Dezotti
“Quid senties igitur?” inquis.		José Dejalma Dezotti
Nihil scilicet nisi de sententia tua, nec prius quidem quam nostrum negotium aut confecerimus aut deposuerimus.		José Dejalma Dezotti
Cura igitur ut ualeas;		José Dejalma Dezotti
aliquando ἀπότριψαι quartanam istam diligentia quae in te summa est.		José Dejalma Dezotti
		José Dejalma Dezotti
**6**	**6**	José Dejalma Dezotti
Cicero Attico sal.	Cícero saúda Ático.	José Dejalma Dezotti
**1** Plane deest quid ad te scribam.		José Dejalma Dezotti
Nota omnia tibi sunt, nec ipse habeo a te quod exspectem.		José Dejalma Dezotti
Tantum igitur nostrum illud sollemne seruemus, ut ne quem istuc euntem sine litteris dimittamus.		José Dejalma Dezotti
**2** De re publica ualde timeo, nec adhuc fere inueni qui non concedendum putaret Caesari quod postularet potius quam depugnandum.		José Dejalma Dezotti
Est illa quidem impudens postulatio, opinione †ualentior†.		José Dejalma Dezotti
Cur autem nunc primum ei resistamus?		José Dejalma Dezotti
“οὐ γὰρ δὴ τόδε μεῖζον ἔπι κακὸν” quam cum quinquennium prorogabamus, aut cum ut absentis ratio haberetur ferebamus, nisi forte haec illi tum arma dedimus ut nunc cum bene parato pugnaremus.		José Dejalma Dezotti
Dices “Quid tu igitur sensurus es?”		José Dejalma Dezotti
Non idem quod dicturus.		José Dejalma Dezotti
Sentiam enim omnia facienda ne armis decertetur, dicam idem quod Pompeius, neque id faciam humili animo.		José Dejalma Dezotti
Sed rursus hoc permagnum rei publicae malum, esse quodam modo mihi praeter ceteros non rectum me in tantis rebus a Pompeio dissidere.		José Dejalma Dezotti
		José Dejalma Dezotti
**7**	**7**	José Dejalma Dezotti
Cicero Attico sal.	Cícero saúda Ático.	José Dejalma Dezotti
**1** “Dionysius, uir optimus, ut mihi quoque est perspectus, et doctissimus tuique amantissimus, Romam uenit XV Kal. Ian. et litteras a te mihi reddidit.”		José Dejalma Dezotti
Tot enim uerba sunt de Dionysio in epistula tua;		José Dejalma Dezotti
illud putato non adscribis, “et tibi gratias egit”.		José Dejalma Dezotti
Atqui certe ille agere debuit et, si esset factum, quae tua est humanitas, adscripsisses.		José Dejalma Dezotti
Mihi autem nulla de eo παλινῳδία datur propter superioris epistulae testimonium.		José Dejalma Dezotti
Sit igitur sane bonus uir;		José Dejalma Dezotti
hoc enim ipsum bene fecit, quod mihi sui cognoscendi penitus etiam istam facultatem dedit.		José Dejalma Dezotti
**2** Philogenes recte ad te scripsit;		José Dejalma Dezotti
curauit enim quod debuit.		José Dejalma Dezotti
Eum ego uti ea pecunia uolui quoad liceret;		José Dejalma Dezotti
itaque usus est menses XIIII.		José Dejalma Dezotti
**3** Pomptinum cupio ualere et, quod scribis in urbem introisse, uereor quid sit;		José Dejalma Dezotti
nam id nisi graui de causa non fecisset.		José Dejalma Dezotti
Ego, quoniam IIII Non. Ian. compitalicius dies est, nolo eo die in Albanum uenire, ne molestus sim familiae;		José Dejalma Dezotti
ueniam III Non. Ian. igitur, inde ad urbem prid. Non.		José Dejalma Dezotti
Tua λῆψις quem in diem incurrat nescio, sed prorsus te commoueri incommodo ualetudinis tuae nolo.		José Dejalma Dezotti
**4** De honore nostro, nisi quid occulte Caesar per suos tribunos molitus erit, cetera uidentur esse tranquilla;		José Dejalma Dezotti
tranquillissimus autem animus meus, qui totum istuc aequi boni facit, et eo magis quod iam a multis audio constitutum esse Pompeio et eius consilio in Siciliam me mittere quod imperium habeam.		José Dejalma Dezotti
Id est ᾿Αβδηριτικόν;		José Dejalma Dezotti
nec enim senatus decreuit nec populus iussit me imperium in Sicilia habere;		José Dejalma Dezotti
sin hoc res publica ad Pompeium refert, qui me magis quam priuatum aliquem mittit?		José Dejalma Dezotti
Itaque si hoc imperium mihi molestum erit, utar ea porta quam primam uidero.		José Dejalma Dezotti
**5** Nam quod scribis mirificam exspectationem esse mei neque tamen quemquam bonorum aut satis bonorum dubitare quid facturus sim, ego quos tu bonos esse dicas non intellego.		José Dejalma Dezotti
Ipse nullos noui, sed ita, si ordines bonorum quaerimus.		José Dejalma Dezotti
Nam singulares sunt boni uiri;		José Dejalma Dezotti
uerum in dissensionibus ordines bonorum et genera quaerenda sunt.		José Dejalma Dezotti
Senatum bonum putas, per quem sine imperio prouinciae sunt (numquam enim Curio sustinuisset, si cum eo agi coeptum esset; quam sententiam senatus sequi noluit, ex quo factum est ut Caesari non succederetur), an publicanos, qui numquam firmi sed nunc Caesari sunt amicissimi, an faeneratores, an agricolas, quibus optatissimum est otium?		José Dejalma Dezotti
Nisi eos timere putas ne sub regno sint qui id numquam, dum modo otiosi essent, recusarunt.		José Dejalma Dezotti
**6** Quid ergo? Exercitum retinentis cum legis dies transierit rationem haberi placet?		José Dejalma Dezotti
Mihi uero ne absentis quidem;		José Dejalma Dezotti
sed cum id datum est, illud una datum est.		José Dejalma Dezotti
Annorum autem decem imperium et ita latum placet?		José Dejalma Dezotti
Placet igitur etiam me expulsum et agrum Campanum perisse et adoptatum patricium a plebeio, Gaditanum a Mytilenaeo, et Labieni diuitiae et Mamurrae placent et Balbi horti et Tusculanum.		José Dejalma Dezotti
Sed horum omnium fons unus est.		José Dejalma Dezotti
Imbecillo resistendum fuit, et id erat facile;		José Dejalma Dezotti
nunc legiones XI, equitatus tantus quantum uolet, Transpadani, plebes urbana, tot tribuni pl., tam perdita iuuentus, tanta auctoritate dux, tanta audacia.		José Dejalma Dezotti
Cum hoc aut depugnandum est aut habenda e lege ratio.		José Dejalma Dezotti
**7** “Depugna” inquis “potius quam seruias.”		José Dejalma Dezotti
Vt quid? Si uictus eris, proscribare, si uiceris, tamen seruias?		José Dejalma Dezotti
“Quid ergo” inquis “acturus es?”		José Dejalma Dezotti
Idem quod pecudes, quae dispulsae sui generis sequuntur greges;		José Dejalma Dezotti
ut bos armenta, sic ego bonos uiros aut eos quicumque dicentur boni sequar, etiam si ruent.		José Dejalma Dezotti
Quid sit optimum male contractis rebus plane uideo;		José Dejalma Dezotti
nemini est enim exploratum cum ad arma uentum sit quid futurum sit, at illud omnibus, si boni uicti sint, nec in caede principum clementiorem hunc fore quam Cinna fuerit nec moderatiorem quam Sulla in pecuniis locupletum.		José Dejalma Dezotti
ἐμπολιτεύομαί σοι iam dudum, et facerem diutius nisi me lucerna desereret.		José Dejalma Dezotti
Ad summam, “dic M. Tulli”.		José Dejalma Dezotti
“Adsentior Cn. Pompeio”, id est T. Pomponio.		José Dejalma Dezotti
Alexim, humanissimum puerum (nisi forte, dum ego absum, adulescens factus est; id enim agere uidebatur), saluere iubeas uelim.		José Dejalma Dezotti
		José Dejalma Dezotti
**8**	**8**	José Dejalma Dezotti
Cicero Attico sal.	Cícero saúda Ático.	José Dejalma Dezotti
**1** Quid opus est de Dionysio tam ualde adfirmare?		José Dejalma Dezotti
An mihi nutus tuus non faceret fidem?		José Dejalma Dezotti
Suspicionem autem eo mihi maiorem tua taciturnitas attulerat, quod et tu soles conglutinare amicitias testimoniis tuis et illum aliter cum aliis de nobis locutum audiebam.		José Dejalma Dezotti
Sed prorsus ita esse ut scribis mihi persuades;		José Dejalma Dezotti
itaque ego is in illum sum quem tu me esse uis.		José Dejalma Dezotti
**2** Diem tuum ego quoque ex epistula tua quadam quam incipiente febricula scripseras mihi notaueram et animaduerteram posse pro re nata te non incommode ad me in Albanum uenire III Non. Ian.		José Dejalma Dezotti
Sed, amabo te, nihil incommodo ualetudinis feceris.		José Dejalma Dezotti
Quid enim est tantum in uno aut altero die?		José Dejalma Dezotti
**3** Dolabellam uideo Liuiae testamento cum duobus coheredibus esse in triente sed iuberi mutare nomen.		José Dejalma Dezotti
Est πολιτικὸν σκέμμα rectumne sit nobili adulescenti nomen mutare mulieris testamento.		José Dejalma Dezotti
Sed id φιλοσοφώτερον διευκρινήσομεν cum sciemus quantum quasi sit in trientis triente.		José Dejalma Dezotti
**4** Quod putasti fore ut ante quam istuc uenirem Pompeium uiderem, factum est ita;		José Dejalma Dezotti
nam VI Kal. ad Lauernium me consecutus est.		José Dejalma Dezotti
Vna Formias uenimus et ab hora octaua ad uesperum secreto collocuti sumus.		José Dejalma Dezotti
Quod quaeris ecquae spes pacificationis sit, quantum ex Pompei multo et accurato sermone perspexi, ne uoluntas quidem est.		José Dejalma Dezotti
Sic enim existimat, si ille uel dimisso exercitu consul factus sit, σύγχυσιν τῆς πολιτείας fore, atque etiam putat eum, cum audierit contra se diligenter parari, consulatum hoc anno neglecturum ac potius exercitum prouinciamque retenturum;		José Dejalma Dezotti
sin autem ille fureret, uehementer hominem contemnebat et suis et rei publicae copiis confidebat.		José Dejalma Dezotti
Quid quaeris? Etsi mihi crebro “ξυνὸς ᾿Ενυάλιος” occurrebat, tamen leuabar cura uirum fortem et peritum et plurimum auctoritate ualentem audiens πολιτικῶς de pacis simulatae periculis disserentem.		José Dejalma Dezotti
**5** Habebamus autem in manibus Antoni contionem habitam X Kal. Ian., in qua erat accusatio Pompei usque a toga pura, querela de damnatis, terror armorum.		José Dejalma Dezotti
In quibus ille “quid censes” aiebat “facturum esse ipsum, si in possessionem rei publicae uenerit, cum haec quaestor eius infirmus et inops audeat dicere?”		José Dejalma Dezotti
Quid multa? Non modo non expetere pacem istam sed etiam timere uisus est.		José Dejalma Dezotti
Ex illa autem sententia relinquendae urbis †mouet† hominem, ut puto.		José Dejalma Dezotti
Mihi autem illud molestissimum est, quod soluendi sunt nummi Caesari et instrumentum triumphi eo conferendum;		José Dejalma Dezotti
est enim ἄμορφον ἀντιπολιτευομένου χρεωφειλέτην esse.		José Dejalma Dezotti
Sed haec et multa alia coram.		José Dejalma Dezotti
		José Dejalma Dezotti
**9**	**9**	José Dejalma Dezotti
Cicero Attico sal.	Cícero saúda Ático.	José Dejalma Dezotti
**1** “Cottidiene” inquis “a te accipiendae litterae sunt?”		José Dejalma Dezotti
Si habebo cui dem, cottidie.		José Dejalma Dezotti
“At iam ipse ades.”		José Dejalma Dezotti
Tum igitur cum uenero desinam.		José Dejalma Dezotti
Vnas uideo mihi a te non esse redditas, quas L. Quinctius, familiaris meus, cum ferret ad bustum Basili uulneratus et despoliatus est.		José Dejalma Dezotti
**2** Videbis igitur num quid fuerit in iis quod me scire opus sit.		José Dejalma Dezotti
Et simul hoc διευκρινήσεις πρόβλημα sane πολιτικόν:		José Dejalma Dezotti
cum sit necesse aut haberi Caesaris rationem illo exercitum uel per senatum uel per tribunos pl. obtinente,		José Dejalma Dezotti
aut persuaderi Caesari ut tradat prouinciam atque exercitum et ita consul fiat,		José Dejalma Dezotti
aut, si id ei non persuadeatur, haberi comitia sine illius ratione illo patiente atque obtinente prouinciam,		José Dejalma Dezotti
aut, si per tribunos pl. non patiatur et tamen quiescat, rem adduci ad interregnum,		José Dejalma Dezotti
aut, si ob eam causam quod ratio eius non habeatur exercitum adducat, armis cum eo contendere, illum autem initium facere armorum aut statim nobis minus paratis aut tum cum comitiis amicis eius postulantibus ut e lege ratio habeatur impetratum non sit, ire autem ad arma aut hanc unam ob causam quod ratio non habeatur aut addita causa si forte tribunus pl. senatum impediens aut populum incitans notatus aut senatus consulto circumscriptus aut sublatus aut expulsus \[sit\] dicensue se expulsum ad illum confugerit, suscepto autem bello aut tenenda sit urbs aut ea relicta ille commeatu et reliquis copiis intercludendus \- quod horum malorum, quorum aliquod certe subeundum est, minimum putes.		José Dejalma Dezotti
**3** Dices profecto persuaderi illi ut tradat exercitum et ita consul fiat.		José Dejalma Dezotti
Est omnino id eius modi ut, si ille eo descendat, contra dici nihil possit, idque eum, si non obtinet ut ratio habeatur retinentis exercitum, non facere miror;		José Dejalma Dezotti
nobis autem, ut quidam putant, nihil est timendum magis quam ille consul.		José Dejalma Dezotti
“At sic malo” inquies “quam cum exercitu.”		José Dejalma Dezotti
Certe; sed istuc ipsum “sic” \[o\] magnum malum putat aliquis, neque ei remedium est ullum;		José Dejalma Dezotti
cedendum est, si id uolet.		José Dejalma Dezotti
“Vide consulem illum iterum quem uidisti consulatu priore.”		José Dejalma Dezotti
“At tum imbecillus plus” inquit “ualuit quam tota res publica.		José Dejalma Dezotti
“Quid nunc putas?”		José Dejalma Dezotti
Et eo consule Pompeio certum est esse in Hispania.		José Dejalma Dezotti
O rem miseram\!		José Dejalma Dezotti
Si quidem id ipsum deterrimum est quod recusari non potest, et quod ille si faciat, iam a bonis omnibus summam ineat gratiam.		José Dejalma Dezotti
**4** Tollamus igitur hoc quo illum posse adduci negant;		José Dejalma Dezotti
de reliquis quid est deterrimum?		José Dejalma Dezotti
Concedere illi quod, ut idem dicit, impudentissime postulat.		José Dejalma Dezotti
Nam quid impudentius?		José Dejalma Dezotti
Tenuisti prouinciam per annos decem non tibi a senatu sed a te ipso per uim et per factionem datos;		José Dejalma Dezotti
praeteriit tempus non legis sed libidinis tuae, fac tamen legis;		José Dejalma Dezotti
ut succedatur decernitur;		José Dejalma Dezotti
impedis et ais “Habe meam rationem”.		José Dejalma Dezotti
Habe tu nostram.		José Dejalma Dezotti
Exercitum tu habeas diutius quam populus iussit, inuito senatu?		José Dejalma Dezotti
“Depugnes oportet, nisi concedis.”		José Dejalma Dezotti
Cum bona quidem spe, ut ait idem, uel uincendi uel in libertate moriendi.		José Dejalma Dezotti
Iam si pugnandum est, quo tempore, in casu, quo consilio, in temporibus situm est.		José Dejalma Dezotti
Itaque te in ea quaestione non exerceo.		José Dejalma Dezotti
Ad ea quae dixi adfer si quid habes.		José Dejalma Dezotti
Equidem dies noctesque torqueor.		José Dejalma Dezotti
		José Dejalma Dezotti
**10**	**10**	José Dejalma Dezotti
Cicero Attico sal.	Cícero saúda Ático.	José Dejalma Dezotti
**1** Subito consilium cepi ut ante quam luceret exirem, ne qui conspectus fieret aut sermo, lictoribus praesertim laureatis.		José Dejalma Dezotti
De reliquo neque hercule quid agam neque quid acturus sim scio;		José Dejalma Dezotti
ita sum perturbatus temeritate nostri amentissimi consili.		José Dejalma Dezotti
Tibi uero quid suadeam, cuius ipse consilium exspecto?		José Dejalma Dezotti
Gnaeus noster quid consili ceperit capiatue nescio adhuc, in oppidis coartatus et stupens.		José Dejalma Dezotti
Omnes, si in Italia consistet, erimus una;		José Dejalma Dezotti
sin cedet, consili res est.		José Dejalma Dezotti
Adhuc certe, nisi ego insanio, stulte omnia et incaute.		José Dejalma Dezotti
Tu, quaeso, crebro ad me scribe uel quod in buccam uenerit.		José Dejalma Dezotti
		José Dejalma Dezotti
**11**	**11**	José Dejalma Dezotti
Cicero Attico sal.	Cícero saúda Ático.	José Dejalma Dezotti
**1** Quaeso, quid est hoc? Aut quid agitur?		José Dejalma Dezotti
Mihi enim tenebrae sunt.		José Dejalma Dezotti
“Cingulum” inquit “nos tenemus, Anconem amisimus;		José Dejalma Dezotti
Labienus discessit a Caesare.”		José Dejalma Dezotti
Vtrum de imperatore populi Romani an de Hannibale loquimur?		José Dejalma Dezotti
O hominem amentem et miserum, qui ne umbram quidem umquam τοῦ καλοῦ uiderit\!		José Dejalma Dezotti
Atque haec ait omnia facere se dignitatis causa.		José Dejalma Dezotti
Vbi est autem dignitas nisi ubi honestas?		José Dejalma Dezotti
Honestum igitur habere exercitum nullo publico consilio, occupare urbis ciuium quo facilior sit aditus ad patriam, χρεῶν ἀποκοπάς, φυγάδων καθόδους, sescenta alia scelera moliri, “τὴν θεῶν μεγίστην ὥστ' ἔχειν τυραννίδα”?		José Dejalma Dezotti
Sibi habeat suam fortunam\!		José Dejalma Dezotti
Vnam mehercule tecum apricationem in illo lucratiuo tuo sole malim quam omnia illius modi regna, uel potius mori miliens quam semel illius modi quicquam cogitare.		José Dejalma Dezotti
**2** “Quid si tu uelis?' inquis.		José Dejalma Dezotti
Age, quis est cui uelle non liceat?		José Dejalma Dezotti
Sed ego hoc ipsum uelle miserius esse duco quam in crucem tolli. una res est ea miserior, adipisci quod ita uolueris.		José Dejalma Dezotti
Sed haec hactenus;		José Dejalma Dezotti
libenter enim in his molestiis ἐνσχολάζω σοι.		José Dejalma Dezotti
**3** Redeamus ad nostrum.		José Dejalma Dezotti
Per fortunas, quale tibi consilium Pompei uidetur?		José Dejalma Dezotti
Hoc quaero, quid urbem reliquerit;		José Dejalma Dezotti
ego enim ἀπορῶ.		José Dejalma Dezotti
Tum nihil absurdius.		José Dejalma Dezotti
Vrbem tu relinquas?		José Dejalma Dezotti
Ergo idem, si Galli uenirent.		José Dejalma Dezotti
“Non est” inquit “in parietibus res publica.”		José Dejalma Dezotti
At in aris et focis.		José Dejalma Dezotti
“Fecit Themistocles.”		José Dejalma Dezotti
Fluctum enim totius barbariae ferre urbs una non poterat.		José Dejalma Dezotti
At idem Pericles non fecit anno fere post quinquagesimo, cum praeter moenia nihil teneret;		José Dejalma Dezotti
nostri olim urbe reliqua capta arcem tamen retinuerunt.		José Dejalma Dezotti
“οὕτως που τῶν πρόσθεν ἐπευθόμεθα κλέα ἀνδρῶν”.		José Dejalma Dezotti
**4** Rursus autem ex dolore municipali sermonibusque eorum quos conuenio uidetur hoc consilium exitum habiturum.		José Dejalma Dezotti
Mira hominum querela est (nescio istic, sed facies ut sciam) sine magistratibus urbem esse, sine senatu.		José Dejalma Dezotti
Fugiens denique Pompeius mirabiliter homines mouet.		José Dejalma Dezotti
Quid quaeris? Alia causa facta est.		José Dejalma Dezotti
Nihil iam concedendum putant Caesari.		José Dejalma Dezotti
Haec tu mihi explica qualia sint.		José Dejalma Dezotti
**5** Ego negotio praesum non turbulento;		José Dejalma Dezotti
uult enim me Pompeius esse quem tota haec Campania et maritima ora habeat ἐπίσκοπον, ad quem dilectus et negoti summa referatur;		José Dejalma Dezotti
itaque uagus esse cogitabam.		José Dejalma Dezotti
Te puto iam uidere quae sit ὁρμὴ Caesaris, qui populus, qui totius negoti status.		José Dejalma Dezotti
Ea uelim scribas ad me, et quidem, quoniam mutabilia sunt, quam saepissime;		José Dejalma Dezotti
acquiesco enim et scribens ad te et legens tua.		José Dejalma Dezotti
		José Dejalma Dezotti
**12**	**12**	José Dejalma Dezotti
Cicero Attico sal.	Cícero saúda Ático.	José Dejalma Dezotti
**1** Vnam adhuc a te epistulam acceperam datam XII Kal. Iun., in qua significabatur aliam te ante dedisse, quam non acceperam.		José Dejalma Dezotti
Sed quaeso ut scribas quam saepissime, non modo si quid scies aut audieris sed etiam si quid suspicabere, maximeque quid nobis faciendum aut non faciendum putes.		José Dejalma Dezotti
Nam quod rogas curem ut scias quid Pompeius agat, ne ipsum quidem scire puto;		José Dejalma Dezotti
nostrum quidem nemo.		José Dejalma Dezotti
**2** Vidi Lentulum consulem Formiis X Kal., uidi Libonem;		José Dejalma Dezotti
plena timoris et erroris omnia.		José Dejalma Dezotti
Ille iter Larinum; ibi enim cohortes et Luceriae et Teani reliquaque in Apulia.		José Dejalma Dezotti
Inde utrum consistere uspiam uelit an mare transire nescitur.		José Dejalma Dezotti
Si manet, uereor ne exercitum firmum habere non possit;		José Dejalma Dezotti
sin discedit, quo aut qua, aut quid nobis agendum sit nescio.		José Dejalma Dezotti
Nam istum quidem cuius Φαλαρισμὸν times omnia taeterrime facturum puto;		José Dejalma Dezotti
nec eum rerum prolatio nec senatus magistratuumque discessus nec aerarium clausum tardabit.		José Dejalma Dezotti
**3** Sed haec, ut scribis, cito sciemus.		José Dejalma Dezotti
Interim uelim mihi ignoscas quod ad te scribo tam multa totiens;		José Dejalma Dezotti
acquiesco enim et tuas uolo elicere litteras maximeque consilium quid agam aut quo me pacto geram.		José Dejalma Dezotti
Demittamne me penitus in causam?		José Dejalma Dezotti
Non deterreor periculo sed dirumpor dolore:		José Dejalma Dezotti
tamne nullo consilio aut tam contra meum consilium gesta esse omnia\!		José Dejalma Dezotti
an cuncter et tergiuerser et iis me dem qui tenent, qui potiuntur?		José Dejalma Dezotti
“αἰδέομαι Τρῶας”, nec solum ciuis sed etiam amici officio reuocor, etsi frangor saepe misericordia puerorum.		José Dejalma Dezotti
**4** Vt igitur ita perturbato, etsi te eadem sollicitant, scribe aliquid et maxime, si Pompeius Italia cedit, quid nobis agendum putes.		José Dejalma Dezotti
M'. quidem Lepidus (nam fuimus una) eum finem statuit, L. Torquatus eundem.		José Dejalma Dezotti
Me cum multa tum etiam lictores impediunt.		José Dejalma Dezotti
Nihil uidi umquam quod minus explicari posset.		José Dejalma Dezotti
Itaque a te nihildum certi exquiro sed quid uideatur, denique ipsam ἀπορίαν tuam cupio cognoscere.		José Dejalma Dezotti
**5** Labienum ab illo discessisse prope modum constat.		José Dejalma Dezotti
Si ita factum esset ut ille Romam ueniens magistratus et senatum Romae offenderet, magno usui causae nostrae fuisset.		José Dejalma Dezotti
Damnasse enim sceleris hominem amicum rei publicae causa uideretur, quod nunc quoque uidetur, sed minus prodest;		José Dejalma Dezotti
non enim habet cui prosit, eumque arbitror paenitere, nisi forte id ipsum est falsum, discessisse illum.		José Dejalma Dezotti
Nos quidem pro certo habebamus.		José Dejalma Dezotti
**6** Et uelim, quamquam, ut scribis, domesticis te finibus tenes, formam mihi urbis exponas, ecquod Pompei desiderium, ecquae Caesaris inuidia appareat, etiam quid censeas de Terentia et Tullia, Romae eas esse an mecum an aliquo tuto loco.		José Dejalma Dezotti
Haec et si quid aliud ad me scribas uelim uel potius scriptites.		José Dejalma Dezotti
		José Dejalma Dezotti
**13**	**13**	José Dejalma Dezotti
Cicero Attico sal.	Cícero saúda Ático.	José Dejalma Dezotti
**1** De Vennonianis rebus tibi adsentior.		José Dejalma Dezotti
Labienum ἥρωα iudico.		José Dejalma Dezotti
Facinus iam diu nullum ciuile praeclarius, qui, ut aliud nihil, hoc tamen profecit, dedit illi dolorem;		José Dejalma Dezotti
sed etiam ad summam profectum aliquid puto.		José Dejalma Dezotti
Amo etiam Pisonem, cuius iudicium de genero suspicor uisum iri graue.		José Dejalma Dezotti
Quamquam genus belli quod sit uides:		José Dejalma Dezotti
ita ciuile est ut non ex ciuium dissensione sed ex unius perditi ciuis audacia natum sit.		José Dejalma Dezotti
Is autem ualet exercitu, tenet multos spe et promissis, omnia omnium concupiuit.		José Dejalma Dezotti
Huic tradita urbs est nuda praesidio, referta copiis.		José Dejalma Dezotti
Quid est quod ab eo non metuas qui illa templa et tecta non patriam sed praedam putet?		José Dejalma Dezotti
Quid autem sit acturus aut quo modo nescio, sine senatu, sine magistratibus;		José Dejalma Dezotti
ne simulare quidem poterit quicquam πολιτικῶς.		José Dejalma Dezotti
Nos autem ubi exsurgere poterimus aut quando?		José Dejalma Dezotti
Quorum dux quam ἀστρατήγητος tu quoque animaduertis, cui ne Picena quidem nota fuerint;		José Dejalma Dezotti
quam autem sine consilio res testis.		José Dejalma Dezotti
Vt enim alia omittam decem annorum peccata, quae condicio non huic fugae praestitit?		José Dejalma Dezotti
**2** Nec uero nunc quid cogitet scio;		José Dejalma Dezotti
ac non desino per litteras sciscitari.		José Dejalma Dezotti
Nihil esse timidius constat, nihil perturbatius.		José Dejalma Dezotti
Itaque nec praesidium, cuius parandi causa ad urbem retentus est, nec locum ac sedem praesidi ullam uideo.		José Dejalma Dezotti
Spes omnis in duabus inuidiose retentis paene alienis legionibus.		José Dejalma Dezotti
Nam dilectus adhuc quidem inuitorum est et a pugnando abhorrentium;		José Dejalma Dezotti
condicionum autem amissum tempus est.		José Dejalma Dezotti
Quid futurum sit non uideo;		José Dejalma Dezotti
commissum quidem a nobis certe est siue a nostro duce ut e portu sine gubernaculis egressi tempestati nos traderemus.		José Dejalma Dezotti
**3** Itaque de Ciceronibus nostris dubito quid agam;		José Dejalma Dezotti
nam mihi interdum amandandi uidentur in Graeciam.		José Dejalma Dezotti
De Tullia autem et Terentia, cum mihi barbarorum aduentus ad urbem proponitur, omnia timeo, cum autem Dolabellae uenit in mentem, paulum respiro.		José Dejalma Dezotti
Sed uelim consideres quid faciendum putes, primum πρὸς τὸ ἀσφαλές (aliter enim mihi de illis ac de me ipso consulendum est), deinde ad opiniones, ne reprehendamur quod eas Romae uelimus esse in communi bonorum fuga.		José Dejalma Dezotti
Quin etiam tibi et Peducaeo (scripsit enim ad me) quid faciatis uidendum est;		José Dejalma Dezotti
is enim splendor est uestrum ut eadem postulentur a uobis quae ab amplissimis ciuibus.		José Dejalma Dezotti
Sed de hoc tu uidebis, quippe cum de me ipso ac de meis te considerare uelim.		José Dejalma Dezotti
**4** Reliquum est ut et quid agatur quoad poteris explores scribasque ad me et quid ipse coniectura adsequare;		José Dejalma Dezotti
quod etiam a te magis exspecto.		José Dejalma Dezotti
Nam acta omnibus nuntiantibus a te exspecto futura;		José Dejalma Dezotti
“μάντις δ' ἄριστος ...”.		José Dejalma Dezotti
Loquacitati ignosces, quae et me leuat ad te quidem scribentem et elicit tuas litteras.		José Dejalma Dezotti
**5** Aenigma succonum ex Velia plane non intellexi;		José Dejalma Dezotti
est enim numero Platonis obscurius.		José Dejalma Dezotti
		José Dejalma Dezotti
**13a**	**13a**	José Dejalma Dezotti
Cicero Attico sal.	Cícero saúda Ático.	José Dejalma Dezotti
**1** Iam intellexi tuum aenigma;		José Dejalma Dezotti
Oppios enim de Velia succones dices.		José Dejalma Dezotti
In eo aestuaui diu.		José Dejalma Dezotti
Quo aperto reliqua patebant et cum Terentiae summa congruebant.		José Dejalma Dezotti
**2** L. Caesarem uidi Minturnis a. d. VIII Kal. Febr. mane cum absurdissimis mandatis, non hominem sed scopas solutas, ut id ipsum mihi ille uideatur irridendi causa fecisse, qui tantis de rebus huic mandata dederit;		José Dejalma Dezotti
nisi forte non dedit et hic sermone aliquo adrepto pro mandatis abusus est.		José Dejalma Dezotti
**3** Labienus, uir mea sententia magnus, Teanum uenit a. d. VIIII Kal.		José Dejalma Dezotti
Ibi Pompeium consulesque conuenit.		José Dejalma Dezotti
Qui sermo fuerit et quid actum sit scribam ad te cum certum sciam.		José Dejalma Dezotti
Pompeius a Teano Larinum uersus profectus est a. d. VIII Kal.;		José Dejalma Dezotti
eo die mansit Venafri.		José Dejalma Dezotti
Aliquantum animi uidetur nobis attulisse Labienus.		José Dejalma Dezotti
Sed ego nondum habeo quod ad te ex his locis scribam;		José Dejalma Dezotti
ista magis exspecto, quid illinc adferatur, quo pacto de Labieno ferat, quid agat Domitius in Marsis, Iguui Thermus, P. Attius Cinguli, quae sit populi urbani uoluntas, quae tua coniectura de rebus futuris.		José Dejalma Dezotti
Haec uelim crebro et quid tibi de mulieribus nostris placeat et quid acturus ipse sis scribas.		José Dejalma Dezotti
Si scriberem ipse, longior epistula fuisset, sed dictaui propter lippitudinem.		José Dejalma Dezotti
		José Dejalma Dezotti
**14**	**14**	José Dejalma Dezotti
Cicero Attico sal.	Cícero saúda Ático.	José Dejalma Dezotti
**1** A. d. VI Kal. Febr. Capuam Calibus proficiscens, cum leuiter lippirem, has litteras dedi.		José Dejalma Dezotti
L. Caesar mandata Caesaris detulit ad Pompeium a. d. VIII Kal., cum is esset cum consulibus Teani.		José Dejalma Dezotti
Probata condicio est, sed ita ut ille de iis oppidis quae extra suam prouinciam occupauisset praesidia deduceret;		José Dejalma Dezotti
id si fecisset, responsum est ad urbem nos redituros esse et rem per senatum confecturos.		José Dejalma Dezotti
Spero posse in praesentia pacem nos habere;		José Dejalma Dezotti
nam et illum furoris et hunc nostrum copiarum suppaenitet.		José Dejalma Dezotti
**2** Me Pompeius Capuam uenire uoluit et adiuuare dilectum;		José Dejalma Dezotti
in quo parum prolixe respondent Campani coloni.		José Dejalma Dezotti
Gladiatores Caesaris qui Capuae sunt, de quibus ante ad te falsum ex Torquati litteris scripseram, sane commode Pompeius distribuit binos singulis patribus familiarum.		José Dejalma Dezotti
Scutorum in ludo CI fuerunt;		José Dejalma Dezotti
eruptionem facturi fuisse dicebantur.		José Dejalma Dezotti
Sane multum in eo rei publicae prouisum est.		José Dejalma Dezotti
**3** De mulieribus nostris, in quibus est tua soror, quaeso uideas ut satis honestum nobis sit eas Romae esse cum ceterae illa dignitate discesserint.		José Dejalma Dezotti
Hoc scripsi ad eas et ad te ipsum antea.		José Dejalma Dezotti
Velim eas cohortere ut exeant, praesertim cum ea praedia in ora maritima habeamus cui ego praesum ut in iis pro re nata non incommode possint esse.		José Dejalma Dezotti
Nam si quid offendimus in genero nostro, quod quidem ego praestare non debeo \- sed id fit maius quod mulieres nostrae praeter ceteras Romae remanserunt.		José Dejalma Dezotti
Tu ipse cum Sexto scire uelim quid cogites de exeundo de totaque re quid existimes.		José Dejalma Dezotti
Equidem ad pacem hortari non desino;		José Dejalma Dezotti
quae uel iniusta utilior est quam iustissimum bellum cum ciuibus.		José Dejalma Dezotti
Sed haec ut fors tulerit.		José Dejalma Dezotti
		José Dejalma Dezotti
**15**	**15**	José Dejalma Dezotti
Cicero Attico sal.	Cícero saúda Ático.	José Dejalma Dezotti
**1** Vt ab urbe discessi, nullum adhuc intermisi diem quin aliquid ad te litterarum darem, non quo haberem magno opere quid scriberem sed ut loquerer tecum absens;		José Dejalma Dezotti
quo mihi, cum coram id non licet, nihil est iucundius.		José Dejalma Dezotti
**2** Capuam cum uenissem a. d. VI Kal., pridie quam has litteras dedi, consules conueni multosque nostri ordinis.		José Dejalma Dezotti
Omnes cupiebant Caesarem abductis praesidiis stare condicionibus iis quas tulisset;		José Dejalma Dezotti
uni Fauonio leges ab illo nobis imponi non placebat, sed is non auditus in consilio.		José Dejalma Dezotti
Cato enim ipse iam seruire quam pugnare mauult;		José Dejalma Dezotti
sed tamen ait in senatu se adesse uelle cum de condicionibus agatur, si Caesar adductus sit ut praesidia deducat.		José Dejalma Dezotti
Ita, quod maxime opus est, in Siciliam ire non curat;		José Dejalma Dezotti
quod metuo ne obsit, in senatu esse uult.		José Dejalma Dezotti
Postumius autem, de quo nominatim senatus decreuit ut statim in Siciliam iret Furfanoque succederet, negat se sine Catone iturum et suam in senatu operam auctoritatemque quam magni aestimat.		José Dejalma Dezotti
Ita res ad Fannium peruenit.		José Dejalma Dezotti
Is cum imperio in Siciliam praemittitur.		José Dejalma Dezotti
**3** In disputationibus nostris summa uarietas est.		José Dejalma Dezotti
Plerique negant Caesarem in condicione mansurum, postulataque haec ab eo interposita esse quo minus quod opus esset ad bellum a nobis pararetur.		José Dejalma Dezotti
Ego autem eum puto facturum ut praesidia deducat;		José Dejalma Dezotti
uicerit enim si consul factus erit, et minore scelere uicerit quam quo ingressus est.		José Dejalma Dezotti
Sed accipienda plaga est;		José Dejalma Dezotti
sumus enim flagitiose imparati cum a militibus tum a pecunia, quam quidem omnem non modo priuatam quae in urbe est sed etiam publicam quae in aerario est illi reliquimus.		José Dejalma Dezotti
Pompeius ad legiones Appianas est profectus;		José Dejalma Dezotti
Labienum secum habet.		José Dejalma Dezotti
Ego tuas opiniones de his rebus exspecto.		José Dejalma Dezotti
Formias me continuo recipere cogitabam.		José Dejalma Dezotti
		José Dejalma Dezotti
**16**	**16**	José Dejalma Dezotti
Cicero Attico sal.	Cícero saúda Ático.	José Dejalma Dezotti
**1** Omnis arbitror mihi tuas litteras redditas esse, sed primas praepostere, reliquas ordine quo sunt missae per Terentiam.		José Dejalma Dezotti
De mandatis Caesaris aduentuque Labieni et responsis consulum ac Pompei scripsi ad te litteris iis quas a. d. V Kal. Capua dedi;		José Dejalma Dezotti
pluraque praeterea in eandem epistulam conieci.		José Dejalma Dezotti
**2** Nunc has exspectationes habemus duas, unam quid Caesar acturus sit cum acceperit ea quae referenda ad illum data sunt L. Caesari, alteram quid Pompeius agat;		José Dejalma Dezotti
qui quidem ad me scribit paucis diebus se firmum exercitum habiturum spemque adfert, si in Picenum agrum ipse uenerit, nos Romam redituros esse.		José Dejalma Dezotti
Labienum secum habet non dubitantem de imbecillitate Caesaris copiarum;		José Dejalma Dezotti
cuius aduentu Gnaeus noster multo animi plus habet.		José Dejalma Dezotti
Nos a consulibus Capuam uenire iussi sumus ad Non. Febr.		José Dejalma Dezotti
Capua profectus sum Formias a. d. III Kal.;		José Dejalma Dezotti
eodem die cum Calibus tuas litteras hora fere nona accepissem, has statim dedi.		José Dejalma Dezotti
**3** De Terentia et Tullia tibi adsentior;		José Dejalma Dezotti
ad quas scripseram ad te ut referrent.		José Dejalma Dezotti
si nondum profectae sunt, nihil est quod se moueant quoad perspiciamus quo loci sit res.		José Dejalma Dezotti
		José Dejalma Dezotti
**17**	**17**	José Dejalma Dezotti
Cicero Attico sal.	Cícero saúda Ático.	José Dejalma Dezotti
**1** Tuae litterae mihi gratae iucundaeque sunt.		José Dejalma Dezotti
De pueris in Graeciam transportandis tum cogitabam cum fuga ex Italia quaeri uidebatur;		José Dejalma Dezotti
nos enim Hispaniam peteremus, illis hoc aeque commodum non erat.		José Dejalma Dezotti
Tu ipse cum Sexto etiam nunc mihi uideris Romae recte esse posse.		José Dejalma Dezotti
Etenim minime amici Pompeio nostro esse debetis;		José Dejalma Dezotti
nemo enim umquam tantum de urbanis praediis detraxit.		José Dejalma Dezotti
Videsne me etiam iocari?		José Dejalma Dezotti
**2** Scire iam te oportet L. Caesar quae responsa referat a Pompeio, quas ab eodem ad Caesarem ferat litteras;		José Dejalma Dezotti
scriptae enim et datae ita sunt ut proponerentur in publico.		José Dejalma Dezotti
In quo accusaui mecum ipse Pompeium qui, cum scriptor luculentus esset, tantas res atque eas quae in omnium manus uenturae essent Sestio nostro scribendas dederit;		José Dejalma Dezotti
itaque nihil umquam legi scriptum Σηστιωδέστερον.		José Dejalma Dezotti
Perspici tamen ex litteris Pompei potest nihil Caesari negari omniaque et cumulate quae postulet dari.		José Dejalma Dezotti
Quae ille amentissimus fuerit nisi acceperit, praesertim cum impudentissime postulauerit.		José Dejalma Dezotti
Quis enim tu es qui dicas “si in Hispaniam profectus erit”, “si praesidia dimiserit”?		José Dejalma Dezotti
Tamen conceditur, minus honeste nunc quidem uiolata iam ab illo re publica illatoque bello quam si olim de ratione habenda impetrasset.		José Dejalma Dezotti
Et tamen uereor ut his ipsis contentus sit.		José Dejalma Dezotti
Nam cum ista mandata dedisset L. Caesari, debuit esse paulo quietior dum responsa referrentur;		José Dejalma Dezotti
dicitur autem nunc esse acerrimus.		José Dejalma Dezotti
**3** Trebatius quidem scribit se ab illo VIIII Kal. Febr. rogatum esse ut scriberet ad me ut essem ad urbem;		José Dejalma Dezotti
nihil ei me gratius facere posse.		José Dejalma Dezotti
Haec uerbis plurimis.		José Dejalma Dezotti
Intellexi ex dierum ratione, ut primum de discessu nostro Caesar audisset, laborare eum coepisse ne omnes abessemus.		José Dejalma Dezotti
Itaque non dubito quin ad Pisonem, quin ad Seruium scripserit.		José Dejalma Dezotti
Illud admiror, non ipsum ad me scripsisse, non per Dolabellam, non per Caelium egisse;		José Dejalma Dezotti
quamquam non aspernor Trebati litteras, a quo me unice diligi scio.		José Dejalma Dezotti
**4** Rescripsi ad Trebatium (nam ad ipsum Caesarem, qui mihi nihil scripsisset, nolui) quam illud hoc tempore esset difficile;		José Dejalma Dezotti
me tamen in praediis meis esse neque dilectum ullum neque negotium suscepisse.		José Dejalma Dezotti
In quo quidem manebo dum spes pacis erit;		José Dejalma Dezotti
sin bellum geretur, non deero officio nec dignitati meae, pueros ὑπεκθέμενος in Graeciam.		José Dejalma Dezotti
Totam enim Italiam flagraturam bello intellego;		José Dejalma Dezotti
tantum mali est excitatum partim ex improbis, partim ex inuidis ciuibus.		José Dejalma Dezotti
Sed haec paucis diebus ex illius ad nostra responsa responsis intellegentur quorsum euasura sint.		José Dejalma Dezotti
Tum ad te scribam plura, si erit bellum;		José Dejalma Dezotti
sin autem otium aut etiam indutiae, te ipsum, ut spero, uidebo.		José Dejalma Dezotti
**5** Ego IIII Non. Febr., quo die has litteras dedi, in Formiano, quo Capua redieram, mulieres exspectabam;		José Dejalma Dezotti
quibus quidem scripseram tuis litteris admonitus ut Romae manerent.		José Dejalma Dezotti
Sed audio maiorem quendam in urbe timorem esse.		José Dejalma Dezotti
Capuae Non. Febr. esse uolebam, quia consules iusserant.		José Dejalma Dezotti
Quicquid huc erit a Pompeio adlatum, statim ad te scribam, tuasque de istis rebus litteras exspectabo.		José Dejalma Dezotti
		José Dejalma Dezotti
**18**	**18**	José Dejalma Dezotti
Cicero Attico sal.	Cícero saúda Ático.	José Dejalma Dezotti
**1** IIII Non. Febr. mulieres nostrae Formias uenerunt tuaque erga se officia plena tui suauissimi studi ad me pertulerunt.		José Dejalma Dezotti
Eas ego, quoad sciremus utrum turpi pace nobis an misero bello esset utendum, in Formiano esse uolui et una Cicerones.		José Dejalma Dezotti
Ipse cum fratre Capuam ad consules (Nonis enim adesse iussi sumus) III Non. profectus sum, cum has litteras dedi.		José Dejalma Dezotti
Responsa Pompei grata populo et probata contioni esse dicuntur;		José Dejalma Dezotti
ita putaram.		José Dejalma Dezotti
Quae quidem ille si repudiarit, iacebit;		José Dejalma Dezotti
si acceperit, uicerit.		José Dejalma Dezotti
“Vtrum igitur” inquies “mauis?”		José Dejalma Dezotti
Responderem si quem ad modum parati essemus scirem.		José Dejalma Dezotti
**2** Cassium erat hic auditum expulsum Ancona eamque urbem a nobis teneri.		José Dejalma Dezotti
Si bellum futurum est, negotium utile.		José Dejalma Dezotti
Caesarem quidem L. Caesare cum mandatis de pace misso tamen aiunt acerrime dilectum habere, loca occupare, uincire praesidiis.		José Dejalma Dezotti
O perditum latronem\!		José Dejalma Dezotti
O uix ullo otio compensandam hanc rei publicae turpitudinem\!		José Dejalma Dezotti
Sed stomachari desinamus, tempori pareamus, cum Pompeio in Hispaniam eamus.		José Dejalma Dezotti
Haec optima in malis, quoniam illius alterum consulatum a re publica ne data quidem occasione reppulimus.		José Dejalma Dezotti
Sed haec hactenus.		José Dejalma Dezotti
**3** De Dionysio fugit me ad te antea scribere;		José Dejalma Dezotti
sed ita constitui, exspectare responsa Caesaris, ut, si ad urbem rediremus, ibi nos exspectaret, sin tardius id fieret, tum eum arcesseremus.		José Dejalma Dezotti
Omnino quid ille facere debuerit in nostra illa fuga, quid docto homine et amico dignum fuerit, cum praesertim rogatus esset, scio, sed haec non nimis exquiro a Graecis.		José Dejalma Dezotti
Tu tamen uidebis, si erit, quod nolim, arcessendus, ne molesti simus inuito.		José Dejalma Dezotti
**4** Quintus frater laborat ut tibi quod debet ab Egnatio soluat;		José Dejalma Dezotti
nec Egnatio uoluntas deest nec parum locuples est, sed cum tale tempus sit ut Q. Titinius (multum enim est nobiscum) uiaticum se neget habere idemque debitoribus suis denuntiarit ut eodem faenore uterentur, atque hoc idem etiam L. Ligus fecisse dicatur, nec hoc tempore aut domi nummos Quintus habeat aut exigere ab Egnatio aut uersuram usquam facere possit, miratur te non habuisse rationem huius publicae difficultatis.		José Dejalma Dezotti
Ego autem etsi illud ψευδησιόδειον (ita enim putatur) obseruo, “μηδὲ δίκην...”, praesertim in te, a quo nihil umquam uidi temere fieri, tamen illius querela mouebar.		José Dejalma Dezotti
Hoc, quicquid est, te scire uolui.		José Dejalma Dezotti
		José Dejalma Dezotti
**19**	**19**	José Dejalma Dezotti
Cicero Attico sal.	Cícero saúda Ático.	José Dejalma Dezotti
**1** Nihil habeo quod ad te scribam, qui etiam eam epistulam quam eram elucubratus ad te non dederim;		José Dejalma Dezotti
erat enim plena spei bonae, quod et contionis uoluntatem audieram et illum condicionibus usurum putabam, praesertim suis.		José Dejalma Dezotti
Ecce tibi III Non. Febr. mane accepi litteras tuas, Philotimi, Furni, Curionis ad Furnium, quibus irridet L. Caesaris legationem.		José Dejalma Dezotti
Plane oppressi uidemur nec quid consili capiam scio.		José Dejalma Dezotti
Nec mehercule de me laboro;		José Dejalma Dezotti
de pueris quid agam non habeo.		José Dejalma Dezotti
Capuam tamen proficiscebar haec scribens, quo facilius de Pompei rebus cognoscerem.		José Dejalma Dezotti
		José Dejalma Dezotti
**20**	**20**	José Dejalma Dezotti
Cicero Attico sal.	Cícero saúda Ático.	José Dejalma Dezotti
**1** Breuiloquentem iam me tempus ipsum facit.		José Dejalma Dezotti
Pacem enim desperaui, bellum nostri nullum administrant;		José Dejalma Dezotti
caue enim putes quicquam esse minoris his consulibus, quorum ego spe audiendi aliquid et cognoscendi nostri apparatus maximo imbri Capuam ueni prid. Non., ut eram iussus.		José Dejalma Dezotti
Illi autem adhuc, id est Nonis, nondum uenerant, sed erant uenturi inanes, imparati.		José Dejalma Dezotti
Gnaeus autem Luceriae dicebatur esse et adire cohortis legionum Appianarum non firmissimarum.		José Dejalma Dezotti
At illum ruere nuntiant et iam iamque adesse, non ut manum conserat (quicum enim?) sed ut fugam intercludat.		José Dejalma Dezotti
**2** Ego autem in Italia “καὶ συναποθανεῖν”, nec te id consulo;		José Dejalma Dezotti
sin extra, quid ago?		José Dejalma Dezotti
Ad manendum hiems, lictores, improuidi et neglegentes duces, ad fugam hortatur amicitia Gnaei, causa bonorum, turpitudo coniungendi cum tyranno;		José Dejalma Dezotti
qui quidem incertum est Phalarimne an Pisistratum sit imitaturus.		José Dejalma Dezotti
Haec uelim explices et me iuues consilio, etsi te ipsum istic iam calere puto;		José Dejalma Dezotti
sed tamen quantum poteris.		José Dejalma Dezotti
Ego si quid hic hodie noui cognoro, scies;		José Dejalma Dezotti
iam enim aderunt consules ad suas Nonas.		José Dejalma Dezotti
Tuas cottidie litteras exspectabo;		José Dejalma Dezotti
ad has autem cum poteris rescribes.		José Dejalma Dezotti
Mulieres et Cicerones in Formiano reliqui.		José Dejalma Dezotti
		José Dejalma Dezotti
**21**	**21**	José Dejalma Dezotti
Cicero Attico sal.	Cícero saúda Ático.	José Dejalma Dezotti
**1** De malis nostris tu prius audis quam ego;		José Dejalma Dezotti
istinc enim emanant.		José Dejalma Dezotti
Boni autem hinc quod exspectes nihil est.		José Dejalma Dezotti
Veni Capuam ad Non. Febr., ita ut iusserant consules.		José Dejalma Dezotti
Eo die Lentulus uenit sero.		José Dejalma Dezotti
Alter consul omnino non uenerat VII Id.;		José Dejalma Dezotti
eo enim die ego Capua discessi et mansi Calibus.		José Dejalma Dezotti
Inde has litteras postridie ante lucem dedi.		José Dejalma Dezotti
Haec Capuae dum fui cognoui:		José Dejalma Dezotti
nihil in consulibus, nullum usquam dilectum;		José Dejalma Dezotti
nec enim conquisitores φαινοπροσωπεῖν audent, cum ille adsit, contraque noster dux nusquam sit, nihil agat, nec nomina dant;		José Dejalma Dezotti
deficit enim non uoluntas sed spes.		José Dejalma Dezotti
Gnaeus autem noster (o rem miseram et incredibilem\!) ut totus iacet\!		José Dejalma Dezotti
Non animus est, non consilium, non copiae, non diligentia.		José Dejalma Dezotti
Mittam illa, fugam ab urbe turpissimam, timidissimas in oppidis contiones, ignorationem non solum aduersari sed etiam suarum copiarum:		José Dejalma Dezotti
hoc cuius modi est?		José Dejalma Dezotti
**2** VII Id. Febr. Capuam C. Cassius tribunus pl. uenit, attulit mandata ad consules ut Romam uenirent, pecuniam de sanctiore aerario auferrent, statim exirent.		José Dejalma Dezotti
Vrbe relicta redeant;		José Dejalma Dezotti
quo praesidio?		José Dejalma Dezotti
Deinde exeant;		José Dejalma Dezotti
quis sinat? Consul ei rescripsit ut prius ipse in Picenum.		José Dejalma Dezotti
At illud totum erat amissum;		José Dejalma Dezotti
sciebat nemo praeter me ex litteris Dolabellae.		José Dejalma Dezotti
Mihi dubium non erat quin ille iam iamque foret in Apulia, Gnaeus noster in naui.		José Dejalma Dezotti
**3** Ego quid agam σκέμμα magnum, neque mehercule mihi quidem ullum, nisi omnia essent acta turpissime neque ego ullius consili particeps \- sed tamen, quid me deceat.		José Dejalma Dezotti
Ipse me Caesar ad pacem hortatur, sed antiquiores litterae quam ruere coepit.		José Dejalma Dezotti
Dolabella, Caelius me illi ualde satis facere.		José Dejalma Dezotti
Mira me ἀπορία torquet.		José Dejalma Dezotti
Iuua me consilio si potes, et tamen ista quantum potes prouide.		José Dejalma Dezotti
Nihil habeo tanta rerum perturbatione quod scribam;		José Dejalma Dezotti
tuas litteras exspecto.		José Dejalma Dezotti
		José Dejalma Dezotti
**22**	**22**	José Dejalma Dezotti
Cicero Attico sal.	Cícero saúda Ático.	José Dejalma Dezotti
**1** Pedem in Italia uideo esse nullum qui non in istius potestate sit.		José Dejalma Dezotti
De Pompeio scio nihil, eumque, nisi in nauim se contulerit, exceptum iri puto.		José Dejalma Dezotti
O celeritatem incredibilem\!		José Dejalma Dezotti
Huius autem nostri \- sed non possum sine dolore accusare eum de quo angor et crucior.		José Dejalma Dezotti
Tu caedem non sine causa times, non quo minus quicquam Caesari expediat ad diuturnitatem uictoriae et dominationis sed uideo quorum arbitrio sit acturus.		José Dejalma Dezotti
Recte †sit† censeo cedendum.		José Dejalma Dezotti
**2** De Oppiis egeo consili.		José Dejalma Dezotti
Quod optimum factu uidebitur facies.		José Dejalma Dezotti
Cum Philotimo loquere, atque adeo Terentiam habebis Idibus.		José Dejalma Dezotti
Ego quid agam?		José Dejalma Dezotti
Qua aut terra aut mari persequar eum qui ubi sit nescio?		José Dejalma Dezotti
Etsi terra quidem qui possum?		José Dejalma Dezotti
Mari quo?		José Dejalma Dezotti
Tradam igitur isti me?		José Dejalma Dezotti
Fac posse tuto (multi enim hortantur), num etiam honeste?		José Dejalma Dezotti
Nullo modo quidem.		José Dejalma Dezotti
A te petam consilium, ut soleo?		José Dejalma Dezotti
Explicari res non potest.		José Dejalma Dezotti
Sed tamen si quid in mentem uenit uelim scribas, et ipse quid sis acturus.		José Dejalma Dezotti
		José Dejalma Dezotti
**23**	**23**	José Dejalma Dezotti
Cicero Attico sal.	Cícero saúda Ático.	José Dejalma Dezotti
**1** V Id. Febr. uesperi a Philotimo litteras accepi Domitium exercitum firmum habere, cohortis ex Piceno Lentulo et Thermo ducentibus cum Domiti exercitu coniunctas esse, Caesarem intercludi posse eumque id timere, bonorum animos recreatos Romae, improbos quasi perculsos.		José Dejalma Dezotti
Haec metuo equidem ne sint somnia, sed tamen M'. Lepidum, L. Torquatum, C. Cassium tribunum pl. (hi enim sunt nobiscum, id est in Formiano) Philotimi litterae ad uitam reuocauerunt.		José Dejalma Dezotti
Ego autem illa metuo ne ueriora sint, nos omnis plane iam captos esse, Pompeium Italia cedere;		José Dejalma Dezotti
quem quidem (o rem acerbam\!) persequi Caesar dicitur.		José Dejalma Dezotti
Persequi Caesar Pompeium?		José Dejalma Dezotti
Quid? Vt interficiat?		José Dejalma Dezotti
O me miserum\!		José Dejalma Dezotti
Et non omnes nostra corpora opponimus?		José Dejalma Dezotti
In quo tu quoque ingemiscis.		José Dejalma Dezotti
Sed quid faciamus?		José Dejalma Dezotti
Victi, oppressi, capti plane sumus.		José Dejalma Dezotti
**2** Ego tamen Philotimi litteris lectis mutaui consilium de mulieribus.		José Dejalma Dezotti
Quas, ut scripseram ad te, Romam remittebam;		José Dejalma Dezotti
sed mihi uenit in mentem multum fore sermonem:		José Dejalma Dezotti
me iudicium iam de causa publica fecisse, qua desperata quasi hunc gradum mei reditus esse quod mulieres reuertissent.		José Dejalma Dezotti
De me autem ipso tibi adsentior, ne me dem incertae et periculosae fugae, cum rei publicae nihil prosim, nihil Pompeio;		José Dejalma Dezotti
pro quo emori cum pie possum tum libenter.		José Dejalma Dezotti
Manebo igitur, etsi uiuere...		José Dejalma Dezotti
**3** Quod quaeris hic quid agatur, tota Capua et omnis hic dilectus iacet;		José Dejalma Dezotti
desperata res est, in fuga omnes sunt, nisi quid eius modi fuerit ut Pompeius istas Domiti copias cum suis coniungat.		José Dejalma Dezotti
Sed uidebamur omnia biduo triduoue scituri.		José Dejalma Dezotti
L. Caesaris litterarum exemplum tibi misi;		José Dejalma Dezotti
rogaras enim.		José Dejalma Dezotti
Cui nos ualde satis facere multi ad me scripserunt;		José Dejalma Dezotti
quod patior facile, dum, ut adhuc, nihil faciam turpiter.		José Dejalma Dezotti
		José Dejalma Dezotti
**24**	**24**	José Dejalma Dezotti
Cicero Attico sal.	Cícero saúda Ático.	José Dejalma Dezotti
**1** Philotimi litterae me quidem non nimis sed eos qui in his locis erant admodum delectarunt.		José Dejalma Dezotti
Ecce postridie Cassio litterae Capua a Lucretio, familiari eius, Nigidium a Domitio Capuam uenisse;		José Dejalma Dezotti
eum dicere Vibullium cum paucis militibus e Piceno currere ad Gnaeum, confestim insequi Caesarem, Domitium non habere militum ui milia.		José Dejalma Dezotti
Idem scripsit Capua consules discessisse.		José Dejalma Dezotti
Non dubito quin Gnaeus in fuga sit;		José Dejalma Dezotti
modo effugiat.		José Dejalma Dezotti
Ego a consilio fugiendi, ut tu censes, absum.		José Dejalma Dezotti
		José Dejalma Dezotti
**25**	**25**	José Dejalma Dezotti
Cicero Attico sal.	Cícero saúda Ático.	José Dejalma Dezotti
**1** Cum dedissem ad te litteras tristis et metuo ne ueras de Lucreti ad Cassium litteris Capua missis, Cephalio uenit a uobis;		José Dejalma Dezotti
attulit etiam a te litteras hilariores nec tamen firmas, ut soles.		José Dejalma Dezotti
Omnia facilius credere possum quam quod scribitis, Pompeium exercitum firmum habere.		José Dejalma Dezotti
Nemo huc ita adfert omniaque quae nolim.		José Dejalma Dezotti
O rem miseram\!		José Dejalma Dezotti
Malas causas semper obtinuit, in optima concidit.		José Dejalma Dezotti
Quid dicam nisi illud eum scisse (neque enim erat difficile), hoc nescisse?		José Dejalma Dezotti
Erat enim ars difficilis recte rem publicam regere.		José Dejalma Dezotti
Sed iam iamque omnia sciemus et scribemus ad te statim.		José Dejalma Dezotti
		José Dejalma Dezotti
**26**	**26**	José Dejalma Dezotti
Cicero Attico sal.	Cícero saúda Ático.	José Dejalma Dezotti
**1** Non uenit idem usu mihi quod tu tibi scribis, “quotiens exorior”;		José Dejalma Dezotti
ego enim nunc primum paulum exorior, et maxime quidem iis litteris quae Roma adferuntur de Domitio, de Picentium cohortibus.		José Dejalma Dezotti
Omnia erant facta hoc biduo laetiora.		José Dejalma Dezotti
Itaque fuga quae parabatur repressa est.		José Dejalma Dezotti
Caesaris interdicta, “si te secundo lumine hic offendero...”, respuuntur;		José Dejalma Dezotti
bona de Domitio, praeclara de Afranio fama est.		José Dejalma Dezotti
**2** Quod me amicissime admones ut me integrum quoad possim seruem, gratum est;		José Dejalma Dezotti
quod addis, ne propensior ad turpem causam uidear, certe uideri possum.		José Dejalma Dezotti
Ego me ducem in ciuili bello quoad de pace ageretur negaui esse, non quin rectum esset sed quia, quod multo rectius fuit, id mihi fraudem tulit.		José Dejalma Dezotti
Plane eum cui noster alterum consulatum deferret et triumphum (at quibus uerbis\! “Pro tuis rebus gestis amplissimis”) inimicum habere nolueram.		José Dejalma Dezotti
Ego scio et quem metuam et quam ob rem.		José Dejalma Dezotti
Sin erit bellum, ut uideo fore, partes meae non desiderabuntur.		José Dejalma Dezotti
**3** De HS XX Terentia tibi rescripsit.		José Dejalma Dezotti
Dionysio, dum existimabam uagos nos fore, nolui molestus esse;		José Dejalma Dezotti
tibi autem crebro ad me scribenti de eius officio nihil rescripsi, quod diem ex die exspectabam ut statuerem quid esset faciendum.		José Dejalma Dezotti
Nunc, ut uideo, pueri certe in Formiano uidentur hiematuri.		José Dejalma Dezotti
Et ego? Nescio.		José Dejalma Dezotti
Si enim erit bellum, cum Pompeio esse constitui.		José Dejalma Dezotti
Quod habebo certi, faciam ut scias.		José Dejalma Dezotti
Ego bellum foedissimum futurum puto, nisi qui, ut tu scribis, Parthicus casus exstiterit.		José Dejalma Dezotti
		José Dejalma Dezotti
