latintext	translation
Marcus Tullius Cicero Epistulae ad Atticum – Liber VI TRADUÇÃO:	Cícero Cartas a Ático – Livro 6 TRADUÇÃO:
José Dejalma Dezotti 1 Cicero Attico sal.	José Dejalma Dezotti 1 Cícero saúda Ático.
1 Accepi tuas litteras a.	1 Recebi tua carta em Laodicéia cinco dias antes das Terminais, a qual li com muitíssimo prazer, tão cheia estava ela de afeto, de humanidade, de dever, de diligência.
d.	Vou, pois, respondê-la (pois assim me pedes) e não vou estabelecer o meu próprio plano, mas manterei a tua ordem.
V Terminalia Laodiceae, quas legi libentissime plenissimas amoris, humanitatis, offici, diligentiae.	Dizes que tens, como carta mais recente minha, a que foi enviada de Cibistra no décimo dia antes das calendas de outubro [22 de setembro] e queres saber quais tuas eu recebi.
Iis igitur respondebo, (sic enim postulas), nec οἰκονομίαν meam instituam sed ordinem conseruabo tuum.	Quase todas que mencionas, exceto aquelas que, segundo escreves, foram entregues aos escravos de Lêntulo e as que foram enviadas de Equo Tutico e Brundísio.
Recentissimas a Cybistris te meas litteras habere ais a.	Por isso teu zelo não está perdido, como receias, mas se põe magnificamente, se na verdade fizeste isso para que eu me deleitasse;
d.	pois com nada eu me deleitei mais.
X Kal.	2 Me alegra muitíssimo que aproves minha sagacidade em relação a Ápio, e também a minha generosidade em relação a Bruto;
Oct.	e eu tinha pensado que ia ser um pouco diferente.
datas et scire uis tuas ego quas acceperim.	Pois Ápio, em sua viagem, tinha enviado duas ou três cartas cheias de queixas, porque eu tinha anulado algumas coisas estabelecidas por ele.
Omnis fere quas commemoras, praeter eas quas scribis Lentuli pueris et quas Equo Tutico et Brundisio datas.	Assim como se um médico, quando o doente foi confiado a outro médico, quisesse irritar-se com esse médico que o sucedeu, caso ele mude algo que ele próprio estabeleceu para curá-lo, assim também Ápio, depois de ter cuidado da província mediante extirpações, de tê-la sangrado, de ter roubado tudo o que pôde, de tê-la entregado a mim esgotada, não vê de bom grado ela sendo revigorada de novo por mim, mas ora fica irritado, ora me agradece.
Qua re non οἴχεται tua industria, quod uereris, sed praeclare ponitur, si quidem id egisti, ut ego delectarer;	Pois nada foi feito por mim com qualquer ofensa a ele;
nam nulla re sum delectatus magis.	somente a diferença de meu método ofende o homem.
2 Quod meam βαθύτητα in Appio tibi, liberalitatem etiam in Bruto probo, uehementer gaudeo;	Pois o que pode ser tão diferente quanto a província ter sido arruinada com gastos e despesas, enquanto ele a governava, quando nós a obtivemos, não ter sido gasta nenhuma moeda nem privadamente nem públicamente?
ac putaram paulo secus.	O que vou dizer ainda de seus prefeitos, acompanhantes, legados?
Appius enim ad me ex itinere bis terue ὑπομεμψιμοίρους litteras miserat quod quaedam a se constituta rescinderem.	Das rapinas, das paixões, das ofensas?
Vt si medicus, cum aegrotus alii medico traditus sit, irasci uelit ei medico qui sibi successerit si quae ipse in curando constituerit immutet ille, sic Appius, cum ἐξ ἀφαιρέσεως prouinciam curarit, sanguinem miserit, quicquid potuit detraxerit, mihi tradiderit enectam, προσανατρεφομένην eam a me non libenter uidet sed modo suscenset, et modo gratias agit.	Já agora nenhuma casa - por hércules - é governada com tanto juízo ou com tanta disciplina ou está tão moderada quanto a nossa província inteira.
Nihil enim a me fit cum ulla illius contumelia;	Alguns amigos de Ápio interpretam isto de modo ridículo:
tantum modo dissimilitudo meae rationis offendit hominem.	eles julgam que eu, neste caso, quero ter boa fama para que ele tenha má e que ajo com retidão não para o meu louvor, mas para a sua desonra.
Quid enim potest esse tam dissimile quam illo imperante exhaustam esse sumptibus et iacturis prouinciam, nobis eam obtinentibus nummum nullum esse erogatum nec priuatim nec publice?	Mas se Ápio, como indicava a carta de Bruto, que ele enviou a ti, me agradece, não o levo a mal, mas nesse mesmo dia em que escrevo esta antes do amanhecer, penso em anular muitas coisas dele estabelecidas e realizadas de modo injusto.
Quid dicam de illius praefectis, comitibus, legatis etiam?	3 Agora venho a Bruto, a quem eu, a teu conselho, acolhi com todo interesse, a quem também eu tinha começado a estimar;
De rapinis, de libidinibus, de contumeliis?	mas digo com franqueza, voltei atrás para não te ofender.
Nunc autem domus mehercule nulla tanto consilio aut tanta disciplina gubernatur aut tam modesta est quam nostra tota prouincia.	Pois não julgues que eu tenha querido algo mais do que satisfazer os seus encargos e que em relação a nenhuma outra coisa eu tenho me esforçado mais.
Haec non nulli amici Appi ridicule interpretantur, qui me idcirco putent bene audire uelle ut ille male audiat et recte facere non meae laudis sed illius contumeliae causa.	Ele, por sua vez, me deu uma lista de encargos e sobre essas mesmas coisas tu tinhas tratado comigo.
Sin Appius, ut Bruti litterae quas ad te misit significabant, gratias nobis agit, non moleste fero, sed tamen eo ipso die quo haec ante lucem scribebam cogitabam eius multa inique constituta et acta tollere.	Levei tudo a cabo com a maior presteza.
3 Nunc uenio ad Brutum, quem ego omni studio te auctore sum complexus, quem etiam amare coeperam;	Em primeiro lugar, pedi a Ariobárzanes que ele lhe desse os talentos que me prometia.
sed plane dico, me reuocaui ne te offenderem.	Enquanto o rei esteve comigo, a coisa estava em excelente situação;
Noli enim putare me quicquam maluisse quam ut mandatis satis facerem nec ulla de re plus laborasse.	depois ele começou a ser pressionado por seiscentos procuradores de Pompeu.
Mandatorum autem mihi libellum dedit, isdemque de rebus tu mecum egeras.	E Pompeu sozinho tem, por diversas razões, mais poder que todos os outros, mas principalmente porque se julga que ele virá para a guerra contra os partos.
Omnia sum diligentissime persecutus.	A ele, contudo, se paga assim agora:
Primum ab Ariobarzane sic contendi, ut talenta quae mihi pollicebatur illi daret.	cada trinta dias trinta e três talentos áticos, e isto sai dos impostos;
Quoad mecum rex fuit, perbono loco res erat;	e isso não cobre suficientemente nem o juro mensal.
post a Pompei procuratoribus sescentis premi coeptus est.	Mas o nosso amigo Cneu suporta isso com clemência;
Pompeius autem cum ob ceteras causas plus potest unus quam ceteri omnes, tum quod putatur ad bellum Parthicum esse uenturus.	não tem capital, e se contenta com esse lucro não sólido.
Ei tamen sic nunc soluitur:	Ele (o rei) não para a nenhum outro nem pode pagar;
tricesimo quoque die talenta Attica XXXIII, et hoc ex tributis;	pois não tem nenhum erário, nenhum imposto.
nec id satis efficitur in usuram menstruam.	exige tributos com a regulamentação de Ápio;
Sed Gnaeus noster clementer id fert;	esses mal são suficientes para cobrir o rendimento de Pompeu.
sorte caret, usura nec ea solida contentus est.	Dois ou três amigos do rei são muito ricos, mas esses mantêm o seu com tanto empenho quanto eu ou tu.
Alii neque soluit cuiquam nec potest soluere;	Na verdade, não deixo, contudo, de rogar, de persuadir, de repreender o rei, por cartas.
nullum enim aerarium, nullum uectigal habet.	4 Dejótaro me contou também que enviou legados a ele a respeito do caso de Bruto;
Appi instituto tributa imperat;	que eles lhe trouxeram a resposta de que ele não tinha.
ea uix in faenus Pompei quod satis sit efficiunt.	E, por hércules, eu também julgo assim, não há nada mais espoliado do que aquele reino, nada mais pobre do que o rei.
Amici regis duo tresue perdiuites sunt, sed ii suum tam diligenter tenent quam ego aut tu.	E assim eu penso ou abdicar de minha tutela ou, como Cévola em favor de Glabrião, rejeitar o lucro e o rendimento.
Equidem non desino tamen per litteras rogare, suadere, accusare regem.	Eu, contudo, concedi as prefeituras que tinha prometido por tua intervenção a Bruto a Marco Escápcio e Lúcio Gávio, que se ocupavam do assunto de Bruto no reino;
4 Deiotarus etiam mihi narrauit se ad eum legatos misisse de re Bruti;	pois não estavam comerciando em minha província.
eos sibi responsum rettulisse illum non habere.	E tu te lembras de que nós atuamos de tal modo que ele tomasse quantas prefeituras quisesse, desde que não para um comerciante;
Et mehercule ego ita iudico, nihil illo regno spoliatius, nihil rege egentius.	e assim lhe dei além disso duas, mas aqueles para os quais ele tinha solicitado tinham ido embora da província.
Itaque aut tutela cogito me abdicare aut, ut pro Glabrione Scaeuola, faenus et impendium recusare.	5 Agora inteira-te sobre a gente de Salamina, pois vejo que também a ti te pegou de surpresa tal qual a mim.
Ego tamen quas per te Bruto promiseram praefecturas M.	Pois nunca ouvi dele que o dinheiro era seu;
Scaptio, L.	e ainda mais, tenho apontamentos dele em que está:
Gauio, qui in regno rem Bruti procurabant, detuli;	“Os salminos devem dinheiro a Marco Escápcio e Públio Matínio, amigos meus”.
nec enim in prouincia mea negotiabantur.	Ele os recomenda a mim;
Tu autem meministi nos sic agere ut quot uellet praefecturas sumeret, dum ne negotiatori;	acrescenta ainda, e, por assim dizer, me estimula, que interpôs em favor deles uma grande quantia.
itaque duas ei praeterea dederam, sed ii quibus petierat de prouincia decesserant.	Eu consegui que pagassem juros de um por cento mensal com acumulação de juros cada ano.
5 Nunc cognosce de Salaminis, quod uideo tibi etiam nouum accidisse, tamquam mihi.	Mas Escápcio pedia quatro por cento.
Numquam enim ex illo audiui illam pecuniam esse suam;	Tive medo de que, se ele conseguisse, tu próprio deixarias de gostar de mim;
quin etiam libellum ipsius habeo in quo est “Salamini pecuniam debent M.	pois eu teria me afastado de meu edito e teria arruinado completamente uma cidade colocada sob a proteção de Catão e do próprio Bruto e provida de meus favores.
Scaptio et P.	6 E neste mesmo momento Escápcio me lança uma carta de Bruto:
Matinio, familiaribus meis”.	que aquele assunto o afetava, o que Bruto nunca dissera nem a mim nem a ti, que também concedesse a prefeitura a Escápcio.
Eos mihi commendat;	Mas, por teu intermédio, tínhamos feito uma exceção, a nenhum comerciante;
adscribit etiam et quasi calcar admouet intercessisse se pro iis magnam pecuniam.	e se a algum, a este, contudo, não.
Confeceram ut soluerent centesimis †sexenni† ductis cum renouatione singulorum annorum.	Pois tinha sido prefeito de Ápio e tinha tido esquadrões de cavalarias, com os quais tinha sitiado em Salamina o senado encerrado na cúria, de modo que cinco senadores morreram de fome.
At Scaptius quaternas postulabat.	E assim eu, no dia em pus o pé na província, quando os legados de Chipre tinham vindo ao meu encontro em Éfeso, mandei uma carta para que os cavaleiros fossem imediatamente embora da ilha.
Metui, si impetrasset, ne tu ipse me amare desineres;	Por causa dessas coisas, creio que Escápcio escreveu a Bruto algo mais injusto sobre mim.
nam ab edicto meo recessissem et ciuitatem in Catonis et in ipsius Bruti fide locatam meisque beneficiis ornatam funditus perdidissem.	Mas, mesmo assim, estou com este ânimo:
6 Atque hoc tempore ipso impingit mihi epistulam Scaptius a Bruto rem illam suo periculo esse, quod nec mihi umquam Brutus dixerat nec tibi, etiam ut praefecturam Scaptio deferrem.	se Bruto julgar que me era necessário decretar quatro por cento, quando em toda a província eu mantinha um por cento e assim eu tinha editado e isso era até mesmo aprovado pelos mais rigorosos prestamistas, se se queixar de que tenha sido denegada a um comerciante a prefeitura, pois eu neguei ao nosso Torquato no caso de teu amigo Lênio, ao próprio Pompeu no caso de Sexto Estácio e obtive a aprovação deles, se levar a mal a retirada dos cavaleiros, vou sofrer, sem dúvida, por ele estar irritado comigo, mas vou sofrer muito mais por ele não ser tal e qual eu o julgava.
Id uero per te exceperamus, ne negotiatori;	7 Em todo caso, Escápcio reconhecerá isto:
quod si cuiquam, huic tamen non.	que, enquanto eu administrava a justiça, ele teve a possibilidade de auferir todo o dinheiro, de acordo com meu edito.
Fuerat enim praefectus Appio, et quidem habuerat turmas equitum, quibus inclusum in curia senatum Salamine obsederat, ut fame senatores quinque morerentur.	Acrescento ainda algo que temo que nem mesmo de ti eu tenha aprovação:
Itaque ego, quo die tetigi prouinciam, cum mihi Cyprii legati Ephesum obuiam uenissent, litteras misi ut equites ex insula statim decederent.	os juros, que havia em meu edito, deviam cessar;
His de causis credo Scaptium iniquius de me aliquid ad Brutum scripsisse.	queriam fazer o depósito:
Sed tamen hoc sum animo:	obtive dos salamínios que calassem.
si Brutus putabit me quaternas centesimas oportuisse decernere, cum tota prouincia singulas obseruarem itaque edixissem idque etiam acerbissimis faeneratoribus probaretur, si praefecturam negotiatori denegatam queretur, quod ego Torquato nostro in tuo Laenio, Pompeio ipsi in Sex.	Eles me fizeram esse favor, mas o que acontecerá a eles se Paulo vier aqui?
Statio negaui et iis probaui, si equites deductos moleste feret, accipiam equidem dolorem mihi illum irasci sed multo maiorem non esse eum talem qualem putassem.	Mas eu concedi tudo isto a Bruto;
7 Illud quidem fatebitur Scaptius, me ius dicente sibi omnem pecuniam ex edicto meo auferendi potestatem fuisse.	e ele te escreveu uma carta muito compreensiva sobre mim, a mim, porém, mesmo quando pede algo, costuma escrever de modo contumaz, arrogante, sem sentido comum.
Addo etiam illud, quod uereor tibi ipsi ut probem:	Tu, porém, eu gostaria que escrevesses a ele sobre essas coisas, para que eu saiba como ele toma isso;
consistere usura debuit, quae erat in edicto meo;	pois tu me informarás.
deponere uolebant:	E, em carta anterior, eu te havia escrito isto detalhadamente, mas quis que compreendesses claramente que não me esqueci daquilo que tu me tinhas escrito em um determinada carta:
impetraui a Salaminis ut silerent.	se eu não tivesse levado desta província nenhuma outra coisa a não ser a boa disposição dele, isso me seria suficiente.
Veniam illi quidem mihi dederunt, sed quid iis fiet si huc Paulus uenerit?	Que seja, já que tu queres assim, mas contudo, creio, com a condição de que se faça sem transgressão minha.
Sed totum hoc Bruto dedi;	Portanto, por meu decreto, a coisa foi imediatamente resolvida para Escápcio.
qui de me ad te humanissimas litteras scripsit, ad me autem, etiam cum rogat aliquid, contumaciter, adroganter, ἀκοινονοήτως solet scribere.	O quanto isso é justo tu julgarás;
Tu autem uelim ad eum scribas de his rebus, ut sciam quo modo haec accipiat;	não vou apelar nem mesmo a Catão.
facies enim me certiorem.	8 Mas não julgues que eu rechacei aqueles teus avisos que estão gravados em minhas vísceras.
Atque haec superioribus litteris diligenter ad te perscripseram, sed plane te intellegere uolui mihi non excidisse illud quod tu ad me quibusdam litteris scripsisses, si nihil aliud de hac prouincia nisi illius beneuolentiam deportassem, mihi id satis esse.	Chorando, me encomendaste a minha reputação;
Sit sane, quoniam ita tu uis, sed tamen cum eo, credo, quod sine peccato meo fiat.	que carta tua há em que não faças menção a ela?
Igitur meo decreto soluta res Scaptio statim.	Por isso que fique irritado quem quiser, eu suportarei;
Quam id rectum sit tu iudicabis;	“pois o bem está do meu lado”, principalmente quando eu próprio me sujeitei a seis livros como garantias, os quais fico contente que sejam tão grandemente aprovados por ti.
ne ad Catonem quidem prouocabo.	Destes perguntas um único ponto histórico a respeito de Cneu Flávio, filho de Ânio.
8 Sed noli me putare ἐγκελεύσματα illa tua abiecisse, quae mihi in uisceribus haerent.	Ele, na verdade, não existiu antes dos decênviros, visto que ele foi edil curul, magistratura que foi instituída muitos anos depois dos decênviros.
Flens mihi meam famam commendasti;	De que serviu então o fato de ter publicado o calendário?
quae epistula tua est in qua mentionem non facias?	Creem que essa tabuinha esteve oculta por um certo tempo, para que os dias hábeis fossem consultados por poucos;
Itaque irascatur qui uolet, patiar;	e, na verdade, não são poucos os autores que sustentam que o escriba Cneu Flávio publicou o calendário e compôs as ações, não penses que eu ou antes o Africano (pois é ele que fala) inventamos uma ficção;
“τὸ γὰρ εὖ μετ' ἐμοῦ”, praesertim cum sex libris tamquam praedibus me ipse obstrinxerim, quos tibi tam ualde probari gaudeo.	não te passou despercebido aquilo sobre o gesto do ator?
E quibus unum ἱστορικὸν requiris de Cn.	Tu suspeitas de modo criminoso, eu escrevi sem segundas intenções.
Flauio, Anni filio.	9 A respeito de minha aclamação como imperator, escreves que ficaste sabendo por uma carta de Filótimo;
Ille uero ante decemuiros non fuit, quippe qui aedilis curulis fuerit, qui magistratus multis annis post decemuiros institutus est.	mas creio que tu, já que estás em Epiro, recebeu duas minhas sobre todos os assuntos, uma após a tomada de Pindenisso, outra de Laodicéia, ambas entregues a teus escravos.
Quid ergo profecit, quod protulit fastos?	Sobre esses assuntos, enviei oficialmente a Roma uma carta por intermédio de dois carteiros por causa dos riscos do mar.
Occultatam putant quodam tempore istam tabulam, ut dies agendi peterentur a paucis;	10 A respeito de Túlia, estou de acordo contigo e escrevi a ela e a Terência que me agrada;
nec uero pauci sunt auctores Cn.	pois tu já tinhas me escrito antes “e eu queria que voltasses ao teu antigo grupo”.
Flauium scribam fastos protulisse actionesque composuisse, ne me hoc uel potius Africanum (is enim loquitur) commentum putes;	Corrigida a carta de Mêmio, não houve nenhum problema;
οὐκ ἔλαθέ σε illud de gestu histrionis?	pois eu prefiro em muito este candidato de Pontídia do que aquele de Servília.
Tu sceleste suspicaris, ego ἀφελῶς scripsi.	Por isso busca o nosso amigo Saufeio, homem que sempre me estimou, agora ainda mais, creio, porque deve ter acrescentado, junto com a herança restante, o afeto de seu irmão Ápio para comigo, o qual declarou frequentemente o quanto me apreciava, especialmente no caso de Bursa.
9 De me imperatore scribis te ex Philotimi litteris cognosse;	Certamente tu me livrarás de uma grande preocupação.
sed credo te, iam in Epiro cum esses, binas meas de omnibus rebus accepisse, unas a Pindenisso capto, alteras Laodicea, utrasque tuis pueris datas.	11 A exceção de Fúrnio não me agrada;
Quibus de rebus propter casum nauigandi per binos tabellarios misi Romam publice litteras.	pois eu não temo nenhum outro período, a não ser o único que ele excetua.
10 De Tullia mea tibi adsentior scripsique ad eam et ad Terentiam mihi placere;	Mas eu te escreveria mais sobre isso, se estivesses em Roma.
tu enim ad me iam ante scripseras “ac uellem te in tuum ueterem gregem rettulisses”.	Não fico surpreso que ponhas em Pompeu toda esperança de paz;
Correcta uero epistula Memmiana nihil negoti fuit;	assim está a coisa e penso que deve ser removido aquele “dissimulando”.
multo enim malo hunc a Pontidia quam illum a Seruilia.	Mas, com efeito, se minha ordem está mais caótica, pôe em ti a culpa;
Qua re adiunges Saufeium nostrum, hominem semper amantem mei, nunc credo eo magis quod debet etiam fratris Appi amorem erga me cum reliqua hereditate creuisse, qui declarauit quanti me faceret cum saepe tum in Bursa.	pois sigo tuas improvisações.
Ne tu me sollicitudine magna liberaris.	12 Os meninos Cíceros se estimam entre si, aprendem, se exercitam;
11 Furni exceptio mihi non placet;	mas um, como disse Isócrates em relação a Éforo e a Teopompo, precisa de freio, o outro, de espora.
nec enim ego ullum aliud tempus timeo nisi quod ille solum excipit.	Penso em dar a toga branca a Quinto nas Liberalia;
Sed scriberem ad te de hoc plura, si Romae esses.	pois seu pai me encarregou.
In Pompeio te spem omnem oti ponere non miror;	Vou considerar como se não houvesse intercalação de dia.
ita res est, remouendumque censeo illud “dissimulantem”.	Dionísio goza de minha afeição.
Sed enim οἰκονομία si perturbatior est, tibi adsignato;	Os meninos, porém, dizem que ele fica furiosamente irritado;
te enim sequor σχεδιάζοντα.	mas não pode haver um homem mais sábio, nem mais virtuoso, nem mais afetuoso contigo e comigo.
12 Cicerones pueri amant inter se, discunt, exercentur;	13 Ouves que Termo e Sílio são louvados com razão;
sed alter, ut Isocrates dixit in Ephoro et Theopompo, frenis eget, alter calcaribus.	eles se comportam muito honestamente.
Quinto togam puram Liberalibus cogitabam dare;	Acrescenta Marco Nônio, Bíbulo e a mim, se quiseres.
mandauit enim pater.	Queria que Escrofa tivesse agora onde tivesse mais poder;
Ea sic obseruabo quasi intercalatum non sit.	pois é um esplêndido indivíduo.
Dionysius mihi quidem in amoribus est.	Os demais consolidam o sistema político de Catão.
Pueri autem aiunt eum furenter irasci;	Por recomendares minha causa a Hortênsio, fico muito agradecido.
sed homo nec doctior nec sanctior fieri potest nec tui meique amantior.	A respeito de Amiano, Dionísio considera não haver nenhuma esperana.
13 Thermum, Silium uere audis laudari;	Não percebi nenhum vestígio de Terêncio.
ualde se honeste gerunt.	Merágenes sem dúvida morreu;
Adde M.	fiz um percurso por sua propriedade e nela não resta nenhum ser vivo.
Nonium, Bibulum, me si uoles.	Isto eu não sabia quando falei sobre essas coisas com o teu Demócrito.
Iam Scrofa uellem haberet ubi posset;	Encarreguei as vasilhas de Roso.
est enim lautum negotium.	Mas olha lá!
Ceteri firmant πολίτευμα Catonis.	o que estás pensando?
Hortensio quod causam meam commendas ualde gratum.	Costumas nos alimentar com verdurinhas em pratos cinzelados com folhas de feto e em magníficos cestos:
De Amiano, spei nihil putat esse Dionysius.	o que eu devo pensar que porás em vasilhas de barro?
Terenti nullum uestigium agnoui.	Uma flauta foi encarregada a Fêmio.
Moeragenes certe periit;	Será encontrada, desde que cante algo digno dela.
feci iter per eius possessionem, in qua animal reliquum nullum est.	14 É iminente a guerra dos partos.
Haec non noram tum cum de ea re cum Democrito tuo locutus sum.	Cássio enviou uma carta inepta, e a de Bíbulo ainda não chegou;
Rhosica uasa mandaui.	lidas essas coisas, acho que enfim o senado haverá de se mover.
Sed heus tu, quid cogitas?	Na verdade estou numa grande perturbação de ânimo.
In felicatis lancibus et splendidissimis canistris holusculis nos soles pascere:	Se, como desejo, minha tarefa não é prorrogada, tenho junho e quintil [julho] em medo.
quid te in uasis fictilibus appositurum putem?	Seja;
κέρας Phemio mandatum est.	Bíbulo, na verdade, resistirá por dois meses.
Reperietur, modo aliquid illo dignum canat.	O que acontecerá com aquele que eu deixar, principalmente se é meu irmão?
14 Parthicum bellum inpendet.	E comigo, se não parto tão rápido?
Cassius ineptas litteras misit, necdum Bibuli erant adlatae;	É um grande problema.
quibus recitatis puto fore ut aliquando commoueatur senatus.	Para mim, contudo, convim com Dejótaro para que ele estivesse com todas as suas tropas em meu acampamento;
Equidem sum in magna animi perturbatione.	ele tem trinta coortes de quatrocentos homens, armadas a nosso estilo e dois mil cavaleiros.
Si, ut opto, non prorogatur nostrum negotium, habeo Iunium et Quintilem in metu.	Será para resistir até que Pompeu chegue, ele que em uma carta que me enviou indica que aquela tarefa será sua.
Esto;	Os partos passam o inverno em nossa província;
duo quidem mensis sustinebit Bibulus.	Orodes em pessoa é esperado.
Quid illo fiet quem reliquero, praesertim si fratrem?	O que queres?
Quid me autem, si non tam cito decedo?	Há bastante tarefa.
Magna turba est.	15 Acerca do edito de Bíbulo, nada de novo além daquela exceção de que tu tinhas escrito a mim “um prejuízo bastante grave em nossa ordem”.
Mihi tamen cum Deiotaro conuenit ut ille in meis castris esset cum suis copiis omnibus;	Eu, contudo, tenho uma com o mesmo valor, mas mais dissimulada, procedente do edito asiático de Quinto Múcio, filho de Públio, “exceto se a transação tenha sido realizada de tal modo que não convém mantê-la de acordo com a boa fé”;
habet autem cohortis quadringenarias nostra armatura XXX, equitum CI CI.	tenho seguido muitos preceitos de Cévola, entre esses aquele no qual os gregos consideram que lhes foi dada a liberdade para que os gregos decidam entre si de acordo com suas próprias leis.
Erit ad sustentandum quoad Pompeius ueniat, qui litteris quas ad me mittit significat suum negotium illud fore.	O edito, porém, é curto devido a esta minha divisão, porque julguei que ele devia ser estabelecido em dois tipos:
Hiemant in nostra prouincia Parthi;	um desses tipos é o provincial, em que estão incluídas as contas das cidades, as dívidas, os juros, os contratos e no mesmo tudo a respeito dos publicanos;
exspectatur ipse Orodes.	o outro, aquilo que nao pode ser levado a cabo suficientemente bem sem um edito, a possessão das heranças, a posse dos bens, a eleição dos síndicos, a venda dos bens, coisas que costumam ser demandadas e feitas a partir de um edito.
Quid quaeris?	O terceiro, acerca do restante da administração da justiça, deixei sem escrita.
Aliquantum est negoti.	Eu disse que acomodaria meus decretos desse tipo aos editos urbanos, e assim cuido e satisfaço até agora a todo mundo.
15 De Bibuli edicto, nihil noui praeter illam exceptionem de qua tu ad me scripseras “nimis graui praeiudicio in ordinem nostrum”.	Os gregos, na verdade, estão exultantes porque se utilizam de juízes estrangeiros.
Ego tamen habeo ἰσοδυναμοῦσαν sed tectiorem ex Q.	“Charlatães, na verdade” dirás.
Muci P.	O que importa?
f.	Eles consideram que adquiriram autonomia.
edicto Asiatico, “extra quam si ita negotium gestum est ut eo stari non oporteat ex fide bona”;	Pois os nossos, creio, têm gente séria, o sapateiro Turpião e o empresário Vétio.
multaque sum secutus Scaeuolae, in iis illud in quo sibi libertatem censent Graeci datam, ut Graeci inter se disceptent suis legibus.	16 Parece que queres saber o que faço a respeito dos publicanos.
Breue autem edictum est propter hanc meam διαίρεσιν, quod duobus generibus edicendum putaui;	Tenho-os em bem-querença, condescendo com eles, louvo-os e adorno com palavras:
quorum unum est prouinciale, in quo inest de rationibus ciuitatum, de aere alieno, de usura, de syngraphis, in eodem omnia de publicanis;	consigo que não sejam molestos a ninguém.
alterum quod sine edicto satis commode transigi non potest, de hereditatum possessionibus, de bonis possidendis, magistris faciendis, bonis uendendis, quae ex edicto et postulari et fieri solent.	O mais surpreendente:
Tertium de reliquo iure dicundo ἄγραφον reliqui.	os juros que eles tinham especificados nos contratos até Servílio manteve;
Dixi me de eo genere mea decreta ad edicta urbana accommodaturum, itaque curo et satis facio adhuc omnibus.	eu assim:
Graeci uero exsultant quod peregrinis iudicibus utuntur.	estabeleço um prazo bastante amplo, se pagarem antes desse, digo que considerarei um por cento ao mês;
“Nugatoribus quidem” inquies.	se não pagarem, será de acordo com o contrato.
Quid refert?	E assim os gregos pagam um juro tolerável e para os publicanos a situação é muito boa, pois já têm aquelas coisas com plena medida, a honra das palavras e frequente convite.
Ii se αὐτονομίαν adeptos putant.	O que mais?
Nostri enim, credo, grauis habent, Turpionem sutorium et Vettium mancipem.	São todos tão amigos meus que cada um se considera o maior;
16 De publicanis quid agam uideris quaerere.	mas “nada os.
Habeo in deliciis, obsequor, uerbis laudo, orno:	.
efficio ne cui molesti sint.	.”
τὸ παραδοξότατον:	sabes o resto.
usuras eorum quas pactionibus adscripserant seruauit etiam Seruilius;	17 Com relação à estátua do Africano (ó assuntos mais desconexos!
ego sic:	mas é precisamente isso que me deliciou em tua carta), o que tu dizes?
diem statuo satis laxam, quam ante si soluerint, dico me centesimas ducturum, si non soluerint, ex pactione.	Este Cipião Metelo não sabe que seu bisavô não foi censor?
Itaque et Graeci soluunt tolerabili faenore et publicanis res est gratissima, si illa iam habent pleno modio, uerborum honorem, inuitationem crebram.	E essa estátua, que está no alto perto da parte posterior do templo de Ops não teve nada mais inscrito a não ser “cos.”
Quid plura?	Porém, naquela que está junto ao Hércules de Policles está inscrito “cos.
Sunt omnes ita mihi familiares ut se quisque maxime putet;	Cens.”
sed tamen “μηδὲν αὐτοῖς” - scis reliqua.	;
17 De statua Africani (ὢ πραγμάτων ἀσυγκλώστων!	e que essa estátua é do mesmo a estatura, o manto, o anel, a própria imagem indicam.
sed me id ipsum delectauit in tuis litteris), ain tu?	Mas, por hércules, eu, quando notei no esquadrão das estátuas equestres douradas que este Metelo pôs no Capitólio uma imagem do Africano com o nome de Sarapião escrito embaixo, achei que era erro do operário, agora vejo que é de Metelo.
Scipio hic Metellus proauum suum nescit censorem non fuisse?	Ó vergonhoso erro histórico!
Atqui nihil habuit aliud inscriptum nisi “cos.”	18 Pois o de Flávio e dos fastos, se é de outro modo, é um erro comum;
ea statua quae ab Opis parte postica in excelso est.	e tu estavas lindamente em dúvida e nós mais ou menos seguimos a opinião pública, como muitas coisas entre os gregos.
In illa autem quae est ad Πολυκλέους Herculem inscriptum est “cos.	Pois quem não disse que Eupólis, o da comédia antiga, foi atirado ao mar por Alcibíades, quando navegava para a Sicília?
Cens.”	Eratóstenes refuta isso;
;	pois apresenta as comédias que ele representou depois daquela data.
quam esse eiusdem status, amictus, anulus, imago ipsa declarat.	Por acaso Dúris de Samos, homem diligente em História, é objeto de riso por que errou junto com muitos?
At mehercule ego, cum in turma inauratarum equestrium quas hic Metellus in Capitolio posuit animaduertissem in Sarapionis subscriptione Africani imaginem, erratum fabrile putaui, nunc uideo Metelli.	Quem não disse que Zaleuco escreveu as leis de Locros?
o ἀνιστορησίαν turpem!	Por acaso Teofrasto está então abatido por isso ter sido repreendido por Timeu, teu amigo?
18 Nam illud de Flauio et fastis, si secus est, commune erratum est;	Mas é vergonhoso não saber que seu próprio bisavô não foi censor, sobretudo quando, após ter sido ele cônsul, não houve nenhum Cornélio censor, enquanto ele esteve vivo.
et tu belle ἠπόρησας et nos publicam prope opinionem secuti sumus, ut multa apud Graecos.	19 Quanto ao que escreves sobre Filótimo e sobre o pagamento de 20.
Quis enim non dixit Εὔπολιν τὸν τῆς ἀρχαίας ab Alcibiade nauigante in Siciliam deiectum esse in mare?	600 sestércios, ouço que Filótimo chegou em Quersoneso por volta da calendas de janeiro [1º.
Redarguit Eratosthenes;	de janeiro];
adfert enim quas ille post id tempus fabulas docuerit.	Mas a mim nada da parte dele até agora.
Num idcirco Duris Samius, homo in historia diligens, quod cum multis errauit, irridetur?	Camilo escreve que recebeu o meu restante.
Quis Zaleucum leges Locris scripsisse non dixit?	Não sei o que é e tenho vontade de saber.
Num igitur iacet Theophrastus si id a Timaeo, tuo familiari, reprehensum est?	Mas, na verdade, isso talvez melhor mais tarde e pessoalmente.
Sed nescire proauum suum censorem non fuisse turpe est, praesertim cum post eum consulem nemo Cornelius illo uiuo censor fuerit.	20 Aquilo quase na parte final da carta, meu querido Ático, me abalou;
19 Quod de Philotimo et de solutione HS XXDC scribis, Philotimum circiter Kal.	pois escreves assim, “o que resta, então?”
Ian.	, depois me suplicas muito carinhosamente que eu não me esqueça de estar alerta e que preste atenção ao que acontece.
in Chersonesum audio uenisse;	O que é que ouviste e a respeito de quem?
At mi ab eo nihil adhuc.	Ainda que não haja nada desse tipo;
Reliqua mea Camillus scribit se accepisse.	Pois nem me teria escapado nem me escapará.
Ea quae sint nescio et aueo scire.	Mas essa advertência tua tão cuidadosa me pareceu indicar não sei o que.
Sed uerum haec posterius et coram fortasse commodius.	21 A respeito de Marco Otávio, te repito novamente que tu já respondeste corretamente a ele;
20 Illud me, mi Attice, in extrema fere parte epistulae commouit;	eu queria com um pouco mais de firmeza.
scribis enim sic, “τί λοιπόν;”, deinde me obsecras amantissime ne obliuiscar uigilare et ut animaduertam quae fiant.	Pois Célio me mandou um liberto e uma carta cuidadosamente escrita sobre as panteras e (+) das cidades.
Num quid de quo inaudisti?	Respondi ao segundo que me sinto mal, se eu me oculto em trevas e não se ouve em Roma que não foi fornecido para as despesas em minha província nenhuma moeda a não ser para as dívidas, e mostrei que nem a mim era permitido conseguir dinheiro nem a ele recebê-lo, e adverti a ele, a quem tenho grande apreço, que, visto que tinha acusado os outros, vivesse com mais cautela;
Etsi nihil eius modi est;	já o outro ponto, que era incompatível com minha reputação que os habitantes de Cíbira caçassem oficialmente por ordem minha.
πολλοῦ γε καὶ δεῖ.	22 Lepta está pulando de alegria com tua carta;
Nec enim me fefellisset nec fallet.	de fato, está magnificamente escrita e me pôs em grande disposição junto a ele.
Sed ista admonitio tua tam accurata nescio quid mihi significare uisa est.	Tua filhinha me fez agradecido por ter te encarregado com diligência que me saudasses, agradecido também a Pília, mas aquela mais atenciosamente porque a mim, que já há muito me quer bem, nunca me viu;
21 De M.	portanto, tu também saúde a ambas.
Octauio, iterum iam tibi rescribo te illi probe respondisse;	O dia da entrega de tua carta, véspera das calendas de janeiro [31 de dezembro] teve uma doce lembrança do famosíssimo juramento que eu não esqueci;
paulo uellem fidentius.	pois fui Magno aquele dia com a toga pretexta.
Nam Caelius libertum ad me misit et litteras accurate scriptas et de pantheris et (+) a ciuitatibus.	Tens tudo;
Rescripsi ad alterum me moleste ferre, si ego in tenebris laterem nec audiretur Romae nullum in mea prouincia nummum nisi in aes alienum erogari, docuique nec mihi conciliare pecuniam licere nec illi capere, monuique eum, quem plane diligo, ut cum alios accusasset cautius uiueret;	não, como pediste, “ouro por bronze”, mas respondemos ponto por ponto.
illud autem alterum alienum esse existimatione mea, Cibyratas imperio meo publice uenari.	23 Eis, porém, outra pequena carta, que não deixarei sem resposta.
22 Lepta tua epistula gaudio exsultat;	Com acerto, por hércules, Luceio pôs à venda sua chácara em Túsculo, a não ser que talvez (como costuma) com seu próprio flautista.
etenim scripta belle est meque apud eum magna in gratia posuit.	e eu queria saber qual é a situação dele.
Filiola tua gratum mihi fecit quod tibi diligenter mandauit ut mihi salutem adscriberes, gratum etiam Pilia, sed illa officiosius quod me, quem iam pridem amat, numquam uidit;	Ouço, na verdade, que o nosso amigo Lêntulo pôs [tudo] à venda, exceto a chácara de Túsculo.
igitur tu quoque salutem utrique adscribito.	Desejo vê-los desembaraçados, desejo também a Séstio, acrescenta, se queres, Célio;
Litterarum datarum dies prid.	em todos esses há “vergonha em recusar, temor em aceitar”.
Kal.	Sobre a restituição de Mêmio acho que ouviste como Curião pensa fazê-lo.
Ian.	Sobre a dívida de Egnácio Sidicino estamo com alguma, não grande esperança.
suauem habuit recordationem clarissimi iuris iurandi quod ego non eram oblitus;	A Pinário, que me recomendas, gravemente doente, Dejótaro cuida dele com o maior empenho.
Magnus enim praetextatus illo die fui.	Respondi também a mais curta.
Habes ad omnia;	24 Queria que tu, enquanto eu estiver em Laodicéia, isto é, até os idos de maio [15 de maio] falasse comigo por cartas o mais frequentemente possível e, quando vieres a Atenas (pois já saberemos sobre os assuntos urbanos, sobre as províncias, tudo que foi aprazado para o mês de março), me envies sobretudo carteiros.
non, ut postulasti, “χρύσεα χαλκείων” sed paria paribus respondimus.	25 E olha tu, vós arrancastes de César por intermédio de Herodes cinquenta talentos áticos?
23 Ecce autem alia pusilla epistula, quam non relinquam ἀναντιφώνητον.	Com isso, conforme ouço, atraístes um grande ódio de Pompeu;
Bene mehercule proposuit Lucceius Tusculanum, nisi forte (solet enim) cum suo tibicine;	pois ele acha que vós comestes o seu próprio dinheiro, que César será mais diligente em edificar no Bosque.
et uelim scire qui sit eius status.	Essas coisas eu ouvi de Públio Védio, um grande patife, mas amigo íntimo de Pompeu.
Lentulum quidem nostrum *** praeter Tusculanum proscripsisse audio.	Este Védio veio ao meu encontro com duas carruagens e um carro com cavalos atrelados e uma liteira e uma grande séquito de escravos, pelo qual, se Curião fizer aprovar sua lei, é necessário que pague cem sestércios por cada um;
Cupio hos expeditos uidere, cupio etiam Sestium, adde sis Caelium;	havia, além disso, um macaco na carruagem e não faltavam burros selvagens.
in quibus omnibus est “αἴδεσθεν μὲν ἀνήνασθαι, δεῖσαν δ' ὑποδέχθαι”.	Nunca vi um homem mais sem valor.
De Memmio restituendo ut Curio cogitet te audisse puto.	Mas escuta o final.
De Egnati Sidicini nomine nec nulla nec magna spe sumus.	Em Laodicéia, ele se hospedou na casa de Pompeu Vindilo;
Pinarium, quem mihi commendas, diligentissime Deiotarus curat grauiter aegrum.	ali deixou suas coisas quando veio até mim.
Respondi etiam minori.	Nesse ínterim, morre Vindilo.
24 Tu uelim dum ero Laodiceae, id est ad Id.	Como se pensava que coisas dele pertenciam a Pompeu Magno, Caio Venônio veio à casa de Vindilo.
Mai.	Quando punha o selo em tudo, deu com as coisas de Védio.
, quam saepissime mecum per litteras colloquare et cum Athenas ueneris (iam enim sciemus de rebus urbanis, de prouinciis, quae omnia in mensem Martium sunt collata) utique ad me tabellarios mittas.	Nestas, foram encontradas cinco pequenos bustos de matronas, nos quais um da irmã de teu amigo, um homem bruto, que se vale deste nome, e o da esposa daquele lépido que leva isso tão negligentemente.
25 Et heus tu, †genua† uos a Caesare per Herodem talenta Attica L extorsistis?	Quis te contar isso;
In quo, ut audio, magnum odium Pompei suscepistis;	pois somos ambos lindamente curiosos.
putat enim suos nummos uos comedisse, Caesarem in Nemore aedificando diligentiorem fore.	26 Eu queria ainda que meditasses uma coisa.
Haec ego ex P.	Ouço que Ápio está fazendo um pórtico em Elêusis;
Vedio, magno nebulone sed Pompei tamen familiari, audiui.	acaso seremos idiotas, se nós fizermos um na Academia?
Hic Vedius mihi obuiam uenit cum duobus essedis et raeda equis iuncta et lectica et familia magna, pro qua, si Curio legem pertulerit, HS centenos pendat necesse est;	“Acho” dirás.
erat praeterea cynocephalus in essedo nec deerant onagri.	Então escreves isso mesmo a mim.
Numquam uidi hominem nequiorem.	Na verdade, eu amo demais a própria Atenas;
Sed extremum audi.	quero ser algum monumento, odeio as falsas inscrições das estátuas alheias.
Deuersatus est Laodiceae apud Pompeium Vindillum;	Mas, se te agradar, me informarás em que dia caem os mistérios romanos e como estás passando o inverno.
ibi sua deposuit cum ad me profectus est.	Cuida para que estejas bem de saúde.
Moritur interim Vindillus.	No septingentésimo sexagésimo quinto dia após a batalha de Leuctra.
Quod res ad Magnum Pompeium pertinere putabatur, C.	2 Cícero saúda Ático.
Vennonius domum Vindilli uenit.	1 Como Filógenes, teu liberto, tivesse vindo até mim em Laodicéia para me saudar e dissesse que logo embarcaria para junto de ti, entreguei-lhe esta carta, na qual respondi àquela que eu tinha recebido do carteiro de Bruto.
Cum omnia obsignaret, in Vedianas res incidit.	E vou responder primeiramente a tua última página, na qual foi de grande preocupação para mim o que foi escrito para ti por Cíncio acerca da conversa de Estácio;
In his inuentae sunt quinque imagunculae matronarum, in quibus una sororis amici tui, hominis bruti qui hoc utatur, et uxoris illius lepidi qui haec tam neglegenter ferat.	o mais preocupante nesta é Estácio dizer que esse plano é aprovado também por mim.
Haec te uolui παριστορῆσαι;	Eu, porém, sobre isso diria apenas que desejo o maior número de laços possível da mais íntima ligação contigo, ainda que sejam estreitíssimos os de nossa afeição;
sumus enim ambo belle curiosi.	está muito longe para que eu queira afrouxar alguma coisa disso com que somos unidos.
26 Vnum etiam uelim cogites.	2 Que ele, por outro lado, costuma falar muito sobre essas coisas com demasiada aspereza frequentemente experimentei, frequentemente também abrandei-o em sua ira;
Audio Appium πρόπυλον Eleusine facere;	julgo que tu sabes isso.
num inepti fuerimus si nos quoque Academiae fecerimus?	Já nesta viagem ao exterior, ou melhor, em nossa campanha militar, muitas vezes o vi inflamado de ira, muitas vezes acalmado.
“Puto” inquies.	O que ele escreveu para Estácio não sei;
Ergo id ipsum scribes ad me.	o que quer que iria fazer acerca de tal assunto não deve ter, contudo, escrito a um liberto.
Equidem ualde ipsas Athenas amo;	Eu terei, porém, o maior cuidado para que nada aconteça diferentemente do que queremos e do que convém.
uolo esse aliquod monumentum, odi falsas inscriptiones statuarum alienarum.	E num caso desse tipo não é suficiente que cada um se mostre responsável, e as maiores partes desse dever são do menino Cícero ou já um jovem;
Sed ut tibi placebit, faciesque me in quem diem Romana incidant mysteria certiorem et quo modo hiemaris.	porque, na verdade, costumo exortá-lo.
Cura ut ualeas.	E a mim me parece que ele ama muito a sua mãe, como deve, e magnificamente a ti;
Post Leuctricam pugnam die septingentesimo sexagesimo quinto.	mas, na verdade, é grande o caráter do garoto, contudo complexo;
2 Cicero Attico sal.	eu tenho um demasiado trabalho de conduzi-lo.
1 Cum Philogenes, libertus tuus, Laodiceam ad me salutandi causa uenisset et se statim ad te nauigaturum esse diceret, has ei litteras dedi, quibus ad eas rescripsi quas acceperam a Bruti tabellario.	3 Visto que respondi a tua última página na primeira minha, agora voltarei para a primeira tua.
Et respondebo primum postremae tuae paginae, qua mihi magnae molestiae fuit quod ad te scriptum est a Cincio de Stati sermone;	Acreditei, pelos mapas de Dicearco, um homem não inútil, mas ainda aprovado pelo teu juízo, que todas as cidades do Peloponeso são marítimas.
in quo hoc molestissimum est, Statium dicere a me quoque id consilium probari.	Ele, em muitos pontos, no relato de Querão sobre Trofônio, repreende os gregos no fato de ter buscado o mar e não excetua um único lugar no Peloponeso.
Ego autem de isto hactenus dixerim, me uel plurima uincla tecum summae coniunctionis optare, etsi sunt amoris artissima;	Ainda que esse autor fosse do meu agrado (pois era um ótimo historiador e tinha vivido no Peloponeso), eu achava estranho, contudo, e, mal acreditando nele, me comuniquei com Dionísio.
tantum abest ut ego ex eo quo astricti sumus laxari aliquid uelim.	E este, em princípio, se sobressaltou, depois, uma vez que tinha acerca desse Dicearco uma opinião não menos boa do que tu de Caio Vestório, eu, de Marco Clúvio, não hesita em acreditarmos nele.
2 Illum autem multa de istis rebus asperius solere loqui saepe sum expertus, saepe etiam leniui iratum;	Pensa que na Arcádia há um Lépreo marítimo;
id scire te arbitror.	Já Tênea e Alífera e Trítia lhe pareciam fundações recentes, e confirmava isso com o catálogo das naus, onde não ocorre menção a elas.
In hac autem peregrinatione militiaue nostra saepe incensum ira uidi, saepe placatum.	E assim eu traduzi palavra por palavra toda essa passagem de Dicearco.
Quid ad Statium scripserit nescio;	Por outro lado sei que se diz “Fliásios” e faz assim para que tenhas;
quicquid acturus de tali re fuit, scribendum tamen ad libertum non fuit.	nós, na verdade, já temos assim.
Mihi autem erit maximae curae ne quid fiat secus quam uolumus quamque oportet.	Mas, no início, tinha me confundido a analogia de Fliunte, Opunte, Sipunte, pelo de Opúntios, Sipúntios;
Nec satis est in eius modi re se quemque praestare, ac maximae partes istius offici sunt pueri Ciceronis siue iam adulescentis;	mas logo em seguida corrigimos isso.
quod quidem illum soleo hortari.	4 Vejo que te alegras com minha moderação e comedimento.
Ac mihi uidetur ualde matrem, ut debet, amare teque mirifice;	Farias mais, se estivesses aqui.
sed est magnum illud quidem uerum tamen multiplex pueri ingenium;	E nessa sessão do tribunal que realizei em Laodicéia dos idos de fevereiro [13 de fevereiro] até as calendas de maio [1º.
quod ego regendo habeo negoti satis.	de maio] para todos os distritos, exceto o da Cilícia, fiz coisas maravilhosas;
3 Quoniam respondi postremae tuae paginae prima mea, nunc ad primam reuertar tuam.	assim muitas cidades foram livradas de toda dívida, muitas foram bastante aliviadas, todas, tendo adquirido sua autonomia e usado suas próprias leis e tribunais, reviveram.
Peloponnesias ciuitates omnis maritimas esse hominis non nequam sed etiam tuo iudicio probati, Dicaearchi tabulis credidi.	Eu lhes dei a possibilidade de livrar-se de suas dívidas ou de aliviá-las por estes dois procedimentos:
Is multis nominibus in Trophoniana Chaeronis narratione Graecos in eo reprehendit quod maritima secuti sint, nec ullum in Peloponneso locum excipit.	um porque não se fez em meu governo absolutamente nenhum gasto;
Cum mihi auctor placeret (etenim erat ἱστορικώτατος et uixerat in Peloponneso), admirabar tamen et uix adcredens communicaui cum Dionysio.	quando digo nenhum não falo em hipérbole:
Atque is primo est commotus, deinde, quod de isto Dicaearcheo non minus bene existimabat quam tu de C.	nenhum, digo, nem sequer a quarta parte de um as.
Vestorio, ego de M.	É incrível o quanto as cidades ressurgiram com este procedimento.
Cluuio, non dubitabat quin ei crederemus.	5 Acrescente-se o outro:
Arcadiae censebat esse Lepreon quoddam maritimum;	eram surpreendentes os roubos dos próprios gregos nas cidades que seus próprios magistrados tinham feito.
Tenea autem et Aliphera et Tritia νεόκτιστα ei uidebantur, idque τῷ τῶν νεῶν καταλόγῳ confirmabat, ubi mentio non fit istorum.	Eu próprio perguntei aos que tinham desempenhado a magistratura nos últimos dez anos;
Itaque istum ego locum totidem uerbis a Dicaearcho transtuli.	confessavam abertamente.
“Phliasios” autem dici sciebam et ita fac ut habeas;	E assim, sem nenhuma desonra, restituíram o dinheiro ao povo a suas proprias custas.
nos quidem sic habemus.	O povo, por sua vez, sem nenhum gemido, devolveram aos publicanos, para os quais neste lustro não tinham pagado nada, e mesmo do lustro anterior;
Sed primo me ἀναλογία deceperat, Φλιοῦς, ᾿Οποῦς, Σιποῦς, quod ᾿Οπούντιοι, Σιπούντιοι;	e assim somos a menina-dos-olhos dos publicanos.
sed hoc continuo correximus.	“Homens agradecidos”, dizes.
4 Laetari te nostra moderatione et continentia uideo.	Notamos.
Tum id magis faceres, si adesses.	Já o resto de minha atuação judicial, não inábil, e clemente, com uma admirável facilidade.
Atque hoc foro quod egi ex Id.	Os acessos a mim nem um pouco provinciais.
Febr.	Nada por meio de um criado de quarto;
Laodiceae ad Kal.	antes do amanhecer, passeio em casa como outrora, quando candidato.
Mai.	Isto é popular e grande e ainda não laborioso para mim graças àquela minha antiga vida militar.
omnium dioecesium praeter Ciliciae mirabilia quaedam effecimus;	6 Nas nonas de maio [7 de maio] penso em ir para Cilícia.
ita multae ciuitates omni aere alieno liberatae, multae ualde leuatae sunt, omnes suis legibus et iudiciis usae αὐτονομίαν adeptae reuixerunt.	depois de passar ali o mês de junho (e tomara que em paz!
His ego duobus generibus facultatem ad se aere alieno liberandas aut leuandas dedi:	pois ameaça uma grande guerra da parte dos partos), estaelecer julho para meu retorno.
uno quod omnino nullus in imperio meo sumptus factus est;	Pois meus serviços anuais se cumprem no terceiro dia antes das calendas de agosto [30 de julho] Estou com grande esperança de que não se prorrogará nenhum minuto.
nullum cum dico non loquor ὑπερβολικῶς:	Tenho as atas da cidade até as nonas de março [7 de março];
nullus inquam, ne terruncius quidem.	destas eu entendo que a firmeza de nosso amigo Curião tratará de tudo antes do que o que diz respeito às províncias.
Hac autem re incredibile est quantum ciuitates emerserint.	Portanto, conforme espero, te verei dentro de pouco tempo.
5 Accessit altera:	7 Passo ao teu querido Bruto, ou melhor, ao nosso (pois preferes assim).
mira erant in ciuitatibus ipsorum furta Graecorum quae magistratus sui fecerant.	Na verdade fiz tudo o que pude realizar em minha província ou tentar no reino.
Quaesiui ipse de iis qui annis decem proximis magistratum gesserant;	Portanto, por todos os meios tratei e trato diariamente com o rei, por meio de cartas evidentemente;
aperte fatebantur.	pois tive-o comigo três ou quatro dias em meio àqueles casos turbulentos dos quais o livrei.
Itaque sine ulla ignominia suis umeris pecunias populis rettulerunt.	Mas então pessoalmente e posteriormente por cartas frequentíssimas não deixei de rogar-lhe e pedir-lhe em meu interesse, de persuadi-lo e aconselhá-lo no seu.
Populi autem nullo gemitu publicanis, quibus hoc ipso lustro nihil soluerant, etiam superioris lustri reddiderunt;	Muito consegui, mas quanto não sei bem, porque estou longe.
itaque publicanis in oculis sumus.	Por outro lado, convenci os salaminos (pois eu podia obrigá-los) a que quisessem pagar toda a sua dívida a Escápcio, mas a um por cento mensal a partir do último contrato e não simples, mas composto por anos.
“Gratis” inquis “uiris.”	Contava-se o dinheiro:
Sensimus.	Escápcio não aceitou.
Iam cetera iuris dictio nec imperita et clemens cum admirabili facilitate.	E tu, que dizes que Bruto deseja ter alguma perda?
Aditus autem ad me minime prouinciales.	“Tinha no contrato quatro por cento mensal”.
Nihil per cubicularium;	Não podia ser, nem, se pudesse, eu podia admitir.
ante lucem inambulabam domi ut olim candidatus.	Ouço que Escápcio está completamente arrependido.
Grata haec et magna mihique nondum laboriosa ex illa uetere militia.	Pois quanto ao que ele dizia que um decreto do senado ordenava que a decisão fosse de acordo com o contrato, por essa razão ocorreu que os Salaminos tinham tomado dinheiro emprestado contra a lei Gabínia.
6 Non.	Essa lei proibia que se pronunciasse uma decisão sobre um dinheiro emprestado desse modo;
Mai.	portanto, o senado decretou que se pronunciasse a decisão de acordo com esse contrato.
in Ciliciam cogitabam;	Agora esse tem a mesma validade jurídica que os outros, nada de privilégio.
ibi cum Iunium mensem consumpsissem (atque utinam in pace!	8 Acho que terei a aprovação de Bruto nessas coisas feitas devidamente por mim, a ti não sei, de Catão com certeza terei a aprovação.
magnum enim bellum impendet a Parthis), Quintilem in reditu ponere.	Mas agora volto a ti.
Annuae enim mihi operae a.	Dizes realmente, Ático, tu, elogiador de nossa integridade e correção?
d.	“Ousaste com tua própria boca” (diz Ênio), pedir-me que desse a Escápcio a cavalaria para recobrar o teu dinheiro?
III Kal.	Por acaso se tu estivesses comigo, tu, que escreves que te irritas por não estar a meu lado, permitirias que eu fizesse isso, se eu quisesse?
Sext.	“Não mais que cinquenta” dizes.
emerentur.	Com Espártaco, no princípio, estiveram muitos menos.
Magna autem in spe sum mihi nihil temporis prorogatum iri.	O que não teriam feito esses malévolos em uma ilha tão frágil?
Habebam acta urbana usque ad Non.	Não teriam feito?
Mart.	Mas e o que não fizeram antes de minha chegada?
;	Mantiveram o senado dos salaminos fechado dentro da cúria durante tão numerosos dias que alguns morreram de fome;
e quibus intellegebam Curionis nostri constantia omnia potius actum iri quam de prouinciis.	pois Escápcio era prefeito de Ápio e tinha pelotões de Ápio.
Ergo, ut spero, prope diem te uidebo.	Então tu, cujo rosto, por hércules, costuma apresentar-se diante de meus olhos quando penso em algum dever ou louvor, tu, eu digo, me pedes que Escápcio seja prefeito?
7 Venio ad Brutum tuum, immo nostrum (sic enim mauis).	Mas tínhamos estabelecido isso, que nenhum comerciante e nisso temos a aprovação de Bruto.
Equidem omnia feci quae potui aut in mea prouincia perficere aut in regno experiri.	Que ele tenha pelotões?
Omni igitur modo egi cum rege et ago cottidie, per litteras scilicet;	Por que é melhor do que coortes?
ipsum enim triduum quadriduumue mecum habui turbulentis in rebus quibus eum liberaui.	9 Com a despesa Escápcio já se torna um dissipador.
Sed et tum praesens et postea creberrimis litteris non destiti rogare et petere mea causa, suadere et hortari sua.	“Os chefes querem” ele diz.
Multum profeci, sed quantum, non plane, quia longe absum, scio.	Sei;
Salaminos autem (hos enim poteram coercere) adduxi ut totum nomen Scaptio uellent soluere, sed centesimis ductis a proxima quidem syngrapha nec perpetuis sed renouatis quotannis.	pois vieram ao meu encontro em Éfeso e, chorando, denunciaram os crimes dos cavaleiros e suas próprias desgraças.
Numerabantur nummi:	E assim entreguei imediatamente uma carta para os cavaleiros saíssem de Chipre antes deu dia determinado e, por esse motivo e por outros, os salaminos nos ergueram ao céu em seus decretos.
noluit Scaptius.	Mas agora que necessidade há de cavalaria?
Quid tu, qui ais Brutum cupere aliquid perdere?	Pois os salaminos pagam;
“Quaternas habebat in syngrapha”.	a não ser que por acaso queiramos conseguir isto pelas armas, que considerem um juro de quatro por cento.
Fieri non poterat nec, si posset, ego pati possem.	E eu vou me atrever a ler alguma vez ou tocar esses livros que tu louvas muitíssimo, se eu fizer algo semelhante?
Audio omnino Scaptium paenitere.	Demais, demais, eu digo, amaste Bruto nisso, ó dulcíssimo Ático, a mim receio que pouco.
Nam quod senatus consultum esse dicebat ut ius ex syngrapha diceretur, eo consilio factum est quod pecuniam Salamini contra legem Gabiniam sumpserant.	E eu escrevi a Bruto que tu tinhas escrito isto a mim.
Vetabat autem ea lex ius dici de ita sumpta pecunia;	10 Fica sabendo agora do resto.
decreuit igitur senatus ut ius diceretur ex ista syngrapha.	Por Ápio, nós fizemos aqui tudo, enfim de modo honrado, mas de muito bom grado;
Nunc ista habet iuris idem quod ceterae, nihil praecipui.	pois não o odeio e gosto de Bruto, e Pompeu, a quem, por hércules, estimo mais e mais a cada dia, me pede com insistência de modo admirável.
8 Haec a me ordine facta puto me Bruto probaturum, tibi nescio, Catoni certe probabo.	Ouviste que o questor Caio Célio vem aqui?
Sed iam ad te ipsum reuertor.	Não sei que classe de homem é.
Ain tandem, Attice, laudator integritatis et elegantiae nostrae?	[Mas] aquele caso de Pamenes não me agrada.
“Ausus es hoc ex ore tuo” (inquit Ennius), ut equites Scaptio ad pecuniam cogendam darem me rogare?	Eu espero estar em Atenas no mês de setembro.
An tu si mecum esses, qui scribis morderi te interdum quod non simul sis, paterere me id facere si uellem?	Queria muito saber as datas de tuas viagens.
“Non amplius” inquis “quinquaginta.”	Soube da ingenuidade de Semprônio Rufo por tua carta de Corcira.
Cum Spartaco minus multi primo fuerunt.	O que queres?
Quid tandem isti mali in tam tenera insula non fecissent?	Invejo o poder de Vestório.
Non fecissent autem?	Eu ainda desejava falar mais agora, mas é dia;
Immo quid ante aduentum meum non fecerunt?	a turba me aperta, Filógenes tem pressa.
Inclusum in curia senatum habuerunt Salaminum ita multos dies ut interierint non nulli fame;	Saúde, portanto, para ti e manda por carta saúde para as nossas queridas Pília e Cecília e recebe um salve de meu Cícero.
erat enim praefectus Appi Scaptius et habebat turmas ab Appio.	3 Cícero saúda Ático.
Id me igitur tu, cuius mehercule os mihi ante oculos solet uersari cum de aliquo officio ac laude cogito, tu me, inquam, rogas praefectus ut Scaptius sit?	1 Ainda que eu não tenha nada de novo que tenha acontecido depois que eu tinha entregado ao teu liberto Filógenes a carta para ti, uma vez que mando Filótimo de volta para Roma, tive de te escrever alguma coisa.
At hoc statueramus, ut negotiatorem neminem, idque Bruto probamus.	Primeiro o que mais me angustia (não que possas me ajudar;
Habeat is turmas?	por quê?
Cur potius quam cohortis?	Pois a coisa está em mãos, tu, porém, estás longe, “e entre mim e ti muitas ondas do vasto mar o Noto faz ondular”) como vês, chega pouco a pouco o dia (pois eu devo ir embora da província no terceiro dia antes das calendas de agosto [30 de julho]), e não há sucessor.
9 Sumptu iam nepos euadit Scaptius.	Quem eu vou deixar para estar à frente da província?
“Volunt” inquit “principes.”	A lógica e a opinião das pessoas pedem meu irmão, primeiro porque parece ser uma honra, portanto ninguém é melhor;
Scio;	segundo porque o tenho como único da categoria pretória.
nam ad me Ephesum usque uenerunt flentesque equitum scelera et miserias suas detulerunt.	Pois Pomptino, segundo o acordo e a convenção (pois ele tinha vindo com essa condição) já tinha se afastado de mim.
Itaque statim dedi litteras ut ex Cypro equites ante certam diem decederent, ob eamque causam tum ob ceteras Salamini nos in caelum decretis suis sustulerunt.	Ninguém considera digno o meu questor;
Sed iam quid opus equitatu?	pois é superficial, libidinoso, gatuno.
Soluunt enim Salamini;	2 Por outro lado, quanto a meu irmão, o primeiro ponto é esse:
nisi forte id uolumus armis efficere, ut faenus quaternis centesimis ducant.	julgo não poder persuadi-lo;
Et ego audebo legere umquam aut attingere eos libros quos tu dilaudas, si tale quid fecero?	pois ele odeia província e, por hércules, não há nada mais odioso, nada mais penoso.
Nimis, nimis, inquam, in isto Brutum amasti, dulcissime Attice, nos uereor ne parum.	Depois, mesmo que ele não queira negar-me, qual é o meu dever?
Atque haec scripsi ego ad Brutum scripsisse te ad me.	Quando se pensa que há na Síria uma grande guerra, essa parece que irromperá nesta província, aqui não há nenhuma proteção, o gasto foi decretado para um ano, pareceria por acaso ser amor de minha parte deixar aqui meu irmão ou diligência deixar algumas bagatelas?
10 Cognosce nunc cetera.	Portanto, como vês, sou atormentado por uma grande preocupação, por uma grande falta de conselho.
Pro Appio nos hic omnia facimus, honeste tamen sed plane libenter;	O que queres?
nec enim ipsum odimus et Brutum amamus et Pompeius mirifice a me contendit, quem mehercule plus plusque in dies diligo.	Não havia necessidade para nós de todo esse assunto.
C.	Quão melhor é a tua província!
Coelium huc quaestorem uenire audisti?	Vais embora quando quiseres, se é que já não foste;
Nescio quid sit hominis.	porás à frente de Tesprótia e Caônia a quem te parecer melhor.
[Sed] Pammenia illa mihi non placent.	Contudo, eu ainda não me encontrei com Quinto, para que eu soubesse se isso lhe agradava ou se isso podia ser conseguido dele;
Ego me spero Athenis fore mense Septembri.	e se pudesse, eu, contudo, não sei o quero.
Tuorum itinerum tempora scire sane uelim.	Isto está, portanto, desse modo.
εὐήθειαν Semproni Rufi cognoui ex epistula tua Corcyraea.	3 O restante, até agora, cheio de louvor e de graça, digno desses livros que muito louvas:
Quid quaeris?	as cidades salvas, se tem plenamente satisfação aos publicanos;
Inuideo potentiae Vestori.	ninguém ofendido com injúria, muito poucos punidos por decreto justo e severo e, contudo, ninguém ousa queixar-se;
Cupiebam etiam nunc plura garrire, sed lucet;	façanhas dignas de triunfo, sobre o qual não faremos nada com avidez, nada com certeza sem realmente o teu conselho.
urget turba, festinat Philogenes.	É difícil a conclusão em transmitir a província;
Valebis igitur et ualere Piliam et Caeciliam nostram iubebis litteris et saluebis a meo Cicerone.	mas algum deus a governará.
3 Cicero Attico sal.	4 Quanto aos assuntos da cidade, evidentemente tu sabes mais, ouves notícias mais frequentemente e mais certas;
1 Etsi nihil sane habebam noui quod post accidisset quam dedissem ad te Philogeni liberto tuo litteras, tamen cum Philotimum Romam remitterem, scribendum aliquid ad te fuit.	na verdade, me dói não ser melhor informado por tuas cartas.
Ac primum illud quod me maxime angebat (non quo me aliquid iuuare posses;	Pois aqui são trazidas odiosas a respeito de Curião, de Paulo;
quippe?	não que eu vojo algum perigo com Pompeu estando de pé ou até mesmo estando sentado, desde que esteja bem de saúde;
res enim est in manibus, tu autem abes longe gentium, “πολλὰ δ' ἐν μεταιχμίῳ νότος κυλίνδει κύματ' εὐρείης ἁλός”):	mas por hércules me dói a sorte de Curião e de Paulo, meus íntimos amigos.
obrepit dies, ut uides (mihi enim a.	Eu queria, portanto, se já estás em Roma ou quando estiveres, que me mandasses um quadro de toda a república que venha ao meu encontro e a partir dela eu possa modelar e planejar com que espírito aproximarei da cidade;
d.	pois é alguma coisa que quem chega não seja estrangeiro ou hóspede.
III Kal.	5 E o que quase deixei passar, fiz de tudo por teu Bruto, como muitas vezes te escrevi.
Sext.	Os cíprios estão pagando;
de prouincia decedendum est), nec succeditur.	mas Escápcio não ficou contente com doze por cento de juro acumulado a cada ano.
Quem relinquam qui prouinciae praesit?	Ariobarzanes não é mais liberal com Pompeu por seu próprio interesse do que pelo meu com Bruto.
Ratio quidem et opinio hominum postulat fratrem, primum quod uidetur esse honos, nemo igitur potior;	Eu, contudo, não posso ser fiador dele;
deinde quod solum habeo praetorium.	pois o rei está muito pobre e eu estou tão longe dele que eu nada posso a não ser por cartas, com as quais não deixo de lutar.
Pomptinus enim ex pacto et conuento (nam ea lege exierat) iam a me discesserat.	Em suma é isto:
Quaestorem nemo dignum putat;	à proporção do dinheiro, Bruto é tratado com mais generosidade do Pompeu.
etenim est leuis, libidinosus, tagax.	A Bruto foram pagos este ano cerca de 100 talentos, a Pompeu foram prometidos 200 para dentro de seis meses.
2 De fratre autem primum illud est:	Agora, no caso de Ápio, mal pode ser dito o quanto eu concedi a Bruto.
persuaderi ei non posse arbitror;	Por que então me angustiar?
odit enim prouinciam, et hercule nihil odiosius, nihil molestius.	Ele tem por amigos meras nulidades, Matínio, Escápcio;
Deinde ut mihi nolit negare, quidnam mei sit offici?	e este, porque não obteve de mim tropas de cavaleiros com as quais acometeria Chipre, como tinha feito antes de mim, talvez esteja irritado, ou porque não é prefeito, posto que não concedi a nenhum comerciante (nem a Caio Venônio, meu amigo íntimo, nem ao teu, Marco Lênio), e eu tinha te mostrado em Roma que iria manter isso;
Cum bellum esse in Syria magnum putetur, id uideatur in hanc prouinciam erupturum, hic praesidi nihil sit, sumptus annuus decretus sit, uideaturne aut pietatis esse meae fratrem relinquere aut diligentiae nugarum aliquid relinquere?	e nisso eu fiquei firme.
Magna igitur, ut uides, sollicitudine adficior, magna inopia consili.	Mas de que poderá se queixar quem não quis tomar seu dinheiro quando podia?
Quid quaeris?	†Escápcio†, que estava na Capadócia, acho que está satisfeito.
Toto negotio nobis opus non fuit.	Tendo ele recebido de mim o tribunato, que eu lhe tinha oferecido por recomendação de uma carta de Bruto, escreveu-me posteriormente que não queria desfrutar desse tribunato.
Quanto tua prouincia melior!	6 Há um tal Gávio, que, depois de eu lhe ter oferecido uma prefeitura a pedido de Bruto, não só disse como fez muitas coisas com algum insulto a mim, um cão de Públio Clódio.
Decedes cum uoles, nisi forte iam decessisti;	Ele não me escoltou quando parti de Apameia nem, quando veio posteriormente ao acampamento e dali se foi, perguntou se eu queria alguma coisa e não sei por que motivo foi claramente não amigo meu.
quem uidebitur praeficies Thesprotiae et Chaoniae.	Se eu o tivesse entre os prefeitos, que homem tu me julgarias?
Necdum tamen ego Quintum conueneram, ut iam si id placeret scirem possetne ab eo impetrari;	Eu, que, como sabes, nunca tolerei a altivez dos homens mais poderosos, iria tolerar a desse lacaio?
nec tamen, si posset, quid uellem habebam.	Ainda que isto seja mais que tolerar, conceder até mesmo algum benefício e honra.
Hoc est igitur eius modi.	Esse Gávio, portanto, como, quando partia para Roma, me tivesse visto recentemente em Apameia, me abordou de um tal modo como eu dificilmente ousaria abordar Culeolo:
3 Reliqua plena adhuc et laudis et gratiae, digna iis libris quos dilaudas:	“De onde” diz ele “me ordenas procurar a comida do prefeito?”
conseruatae ciuitates, cumulate publicanis satis factum;	Respondi, de um modo mais brando do que consideravam ser conveniente os que estavam presentes, que eu não tinha instituído dar comida àqueles cujo serviço eu não tinha utilizado.
offensus contumelia nemo, decreto iusto et seuero perpauci, nec tamen quisquam ut queri audeat;	Foi embora irado.
res gestae dignae triumpho, de quo ipso nihil cupide agemus, sine tuo quidem consilio certe nihil.	7 Se Bruto pode se deixar levar pelo discurso desse patife, será lícito que tu o estimes sozinho, não me terás como rival.
Clausula est difficilis in tradenda prouincia;	Mas acho que ele será aquele que deve ser;
sed haec deus aliquis gubernabit.	contudo, eu quis que a questão fosse conhecida de ti e a ele próprio escrevi muito detalhadamente essas coisas.
4 De urbanis rebus scilicet plura tu scis, saepius et certiora audis;	Absolutamente nunca (pois estamos entre nós) Bruto me enviou uma carta, nem mesmo mais recentemente acerca de Ápio, na qual não haja algo arrogante e sem sentido comum.
equidem doleo non me tuis litteris certiorem fieri.	Tu, porém, costumas ter com frequência na boca:
Huc enim odiosa adferebantur de Curione, de Paulo;	“Mas Grânio não se menospreza e odeia os reis soberbos.”
non quo ullum periculum uideam stante Pompeio uel etiam sedente, ualeat modo;	Nisso, contudo, ele costuma provocar em mim mais riso do que raiva;
sed mehercule Curionis et Pauli, meorum familiarium, uicem doleo.	mas claramente pensa pouco o que escreve ou a quem.
Formam igitur mihi totius rei publicae, si iam es Romae aut cum eris, uelim mittas quae mihi obuiam ueniat, ex qua me fingere possim et praemeditari quo animo accedam ad urbem;	8 O menino Quinto Cícero leu, conforme opino, e com certeza, a carta escrita para o pai dele;
est enim quiddam aduenientem non esse peregrinum atque hospitem.	pois costuma abri-las, e isso por conselho meu, se por acaso há algo que é necessário que se saiba.
5 Et quod paene praeterii, Bruti tui causa, ut saepe ad te scripsi, feci omnia.	Nessa carta estava aquilo mesmo que me escreveste a respeito de tua irmã.
Cyprii numerabant;	Vi o garoto extremamente perturbado;
sed Scaptius centesimis renouato in singulos annos faenore contentus non fuit.	lamentou-se comigo chorando.
Ariobarzanes non in Pompeium prolixior per ipsum quam per me in Brutum.	O que queres?
Quem tamen ego praestare non poteram;	Notei nele um admirável carinho, doçura e delicadeza;
erat enim rex perpauper aberamque ab eo ita longe ut nihil possem nisi litteris, quibus pugnare non destiti.	por isso tenho a maior esperança de que não será nada diferente do que convém.
Summa haec est:	Quis, portanto, que tu soubesses isso.
pro ratione pecuniae liberalius est Brutus tractatus quam Pompeius.	9 Nem mesmo o seguinte eu vou deixar passar:
Bruto curata hoc anno talenta circiter C, Pompeio in sex mensibus promissa CC.	Hortênsio filho se comportou nos jogos de gladiadores em Laodicéia de modo escandaloso e vergonhoso Por causa de seu pai o convidei para jantar no dia em que chegou, e por causa do mesmo pai nada mais.
Iam in Appi negotio quantum tribuerim Bruto dici uix potest.	Ele me disse que me esperaria em Atenas para ir embora comigo.
Quid est igitur quod laborem?	“Tudo bem” eu digo;
Amicos habet meras nugas, Matinium, Scaptium;	pois o que eu ia dizer?
qui quia non habuit a me turmas equitum quibus Cyprum uexaret, ut ante me fecerat, fortasse suscenset, aut quia praefectus non est, quod ego nemini tribui negotiatori (non C.	Acho que não significa absolutamente nada o que ele disse;
Vennonio, meo familiari, non tuo, M.	Na verdade, não quero, para não ofender seu pai, a quem, por hércules, muito estimo.
Laenio), et quod tibi Romae ostenderam me seruaturum;	Mas se ele for meu companheiro, vou agir moderadamente a ponto de não ofender aquele que de modo algum quero.
in quo perseueraui.	10 Estas são as coisas.
Sed quid poterit queri is qui auferre pecuniam cum posset noluit?	Mais isso:
†Aut Scaptius† qui in Cappadocia fuit puto esse satis factum.	gostaria que me enviasses o discurso de Quinto Céler contra Marco Servílio.
Is a me tribunatum cum accepisset, quem ego ex Bruti litteris ei detulissem, postea scripsit ad me se uti nolle eo tribunatu.	Mande um carta o mais breve possível;
6 Gauius est quidam, cui cum praefecturam detulissem Bruti rogatu multa et dixit et fecit cum quadam mea contumelia, P.	se não houver nada, escreve isso mesmo, que não há nada, até mesmo por meio de teu carteiro.
Clodi canis.	Diz saúde para Pília e para tua filha.
Is me nec proficiscentem Apamea prosecutus est nec, cum postea in castra uenisset atque inde discederet, num quid uellem rogauit et fuit aperte mihi nescio qua re non amicus.	Cuida para que fiques bem.
Hunc ego si in praefectis habuissem, quem tu me hominem putares?	4 Cícero saúda Ático.
Qui, ut scis, potentissimorum hominum contumaciam numquam tulerim, ferrem huius adseculae?	1 Cheguei em Tarso nas nonas de junho [5 de junho] Ali muitas coisas me perturbaram:
Etsi hoc plus est quam ferre, tribuere etiam aliquid benefici et honoris.	a grande guerra na Síria, grandes roubos na Cilícia, um modo difícil para mim de administrar, porque eu tinha poucos dias restantes de meu cargo anual, e o mais difícil, por um decreto do senado, era preciso deixar alguém que ficasse à frente da província.
Is igitur Gauius, cum Apameae me nuper uidisset Romam proficiscens, me ita appellauit ut Culleolum uix auderem:	Nada pode ser menos admissível do que o questor Mescínio.
“Vnde” inquit “me iubes petere cibaria praefecti?”	Já acerca de Célio nada ouvimos.
Respondi lenius quam putabant oportuisse qui aderant, me non instituisse iis dare cibaria quorum opera non essem usus.	Me parece o mais certo deixar meu irmão Quinto com o comando;
Abiit iratus.	nisso há muitos incômodos, a nossa separação, o perigo da guerra, a má qualidade dos soldados, além de outros seiscentos problemas.
7 Huius nebulonis oratione si Brutus moueri potest, licebit eum solus ames, me aemulum non habebis.	Ó coisa inteira odiosa!
Sed illum eum futurum esse puto qui esse debet;	Mas isso a fortuna verá, já que não há muita possibilidade de lançar mão de conselho.
tibi tamen causam notam esse uolui et ad ipsum haec perscripsi diligentissime.	2 Tu, visto que (como espero) chegaste em Roma são e salvo, olharás, como costumas, tudo o que entendes ser do meu interesse, sobretudo em relação à minha Túlia, sobre cujo casamento escrevi para Terência o que me agradava, enquanto tu estavas na Grécia;
Omnino (soli enim sumus) nullas umquam ad me litteras misit Brutus, ne proxime quidem de Appio, in quibus non inesset adrogans et ἀκοινονόητον aliquid.	depois acerca de minha honraria.
Tibi autem ualde solet in ore esse:	Pois uma vez que tu estiveste ausente, receio que não se tratou de minha carta de um modo suficientemente atento.
“Granius autem non contemnere se et reges odisse superbos.”	3 Além do mais, vou te escrever com o maior mistério, tu sagazmente sentirás o cheiro.
In quo tamen ille mihi risum magis quam stomachum mouere solet;	Não posso escrever tudo que temo;
sed plane parum cogitat quid scribat aut ad quem.	Tu, porém, faze com que uma carta tua voe ao meu encontro.
8 Q.	Estas coisas eu escrevi às pressas em viagem e com o exército.
Cicero puer legit, ut opinor, et certe, epistulam inscriptam patri suo;	Manda saúde a Pília e à belíssima menina Cecília.
solet enim aperire, idque de meo consilio, si quid forte sit quod opus sit sciri.	5 Cícero saúda Ático.
In ea autem epistula erat idem illud de sorore quod ad me.	1 Agora com toda certeza estás em Roma, aonde me alegro de teres são e salvo, se é assim;
Mirifice conturbatum uidi puerum;	por todo o tempo que estiveste afastado daí, parecias estar mais afastado de mim do que se estivesses em casa.
lacrimans mecum est questus.	Pois me eram menos conhecidos os meus assuntos, menos também os públicos.
Quid quaeris?	Por isso eu gostaria, ainda que (como espero), quando estiveres lendo esta, já terei avançado um bom tanto do caminho, que mesmo assim mandasses com frequência ao meu encontro cartas o mais minuciosas possível sobre todos os assuntos, principalmente sobre o que te escrevi anteriormente.
Miram in eo pietatem, suauitatem humanitatemque perspexi;	2 Investiga isso, como costumas, e mais isto:
quo maiorem spem habeo nihil fore aliter ac deceat.	.
Id te igitur scire uolui.	.
9 Ne illud quidem praetermittam:	.
Hortensius filius fuit Laodiceae gladiatoribus, flagitiose et turpiter.	e me censurou com o velho provérbio.
Hunc ego patris causa uocaui ad cenam quo die uenit, et eiusdem patris causa nihil amplius.	.
Is mihi dixit se Athenis me exspectaturum ut mecum decederet.	.
“Recte” inquam;	3 Vê o restante e examina com atenção o que pode ser feito.
quid enim dicerem?	Nós, embora tenhamos já quase acabado o nosso tempo (pois restam 33 dias), somos, contudo, sobremaneira assolados pela preocupação com a província.
Omnino puto nihil esse quod dixit;	Pois embora a Síria ardesse em guerra e Bíbulo, em meio de sua tão grande dor, tomasse a seu cargo o maior peso da guerra, e seus legados e seu questor e seus amigos me enviassem carta para que eu viesse em sua ajuda, ainda que eu tivesse um fraco exército, mas tropas auxiliares bastante boas de gálatas, písídas, lícios (pois estes são as nossas forças), mesmo assim considerei ser o meu dever ter o exército o mais próximos possível do inimigo enquanto me fosse permitido estar à frente da província pelo decreto do senado.
nolo quidem, ne offendam patrem, quem mehercule multum diligo.	Mas aquilo com que eu mais me comprazia é que Bíbulo não estava aborrecido comigo, me escrevia de preferência sobre todos os assuntos.
Sin fuerit meus comes, moderabor ita ne quid eum offendam quem minime uolo.	E o dia da partida chega para mim imperceptivelmente.
10 Haec sunt.	E quando este chegar, outro problema, a quem porei no comando, se o questor Caldo não chegar;
Etiam illud:	a respeito dele não tínhamos até o momento nada de certo.
orationem Q.	4 Eu desejava, por hércules, compor uma carta mais longa, mas nem havia assunto sobre o qual escrever nem eu podia joguetear por causa de minha preocupação.
Celeris mihi uelim mittas contra M.	Ficarás bem, portanto, e dizes saúde à tua garota Atícula e à nossa Pília.
Seruilium.	6 Cícero saúda Ático.
Litteras mitte quam primum;	1 Enquanto eu em mnha província honro Ápio por todas as coisas, de repente me tornei sogro de seu acusador.
si nihil erit, id ipsum scribes, nihil fieri, uel per tuum tabellarium.	“Que os deuses realmente favoreçam isso!”
Piliae et filiae salutem.	dizes.
Cura ut ualeas.	Eu queria assim e sei com certeza que tu desejas assim.
4 Cicero Attico sal.	Mas acredita em mim, era a última coisa que eu achava, eu, que tinha enviado às mulheres [Terência e Túlia] pessoas de confiança a respeito de Tibério Nerão, que tinha tratado comigo;
1 Tarsum ueni Non.	que chegaram em Roma, depois de realizados os esponsais.
Iun.	Mas espere que isso seja o melhor.
Ibi me multa mouerunt:	Entendo que realmente as mulheres muito se deleitam com a cortesia e amabilidade do jovem.
magnum in Syria bellum, magna in Cilicia latrocinia, mihi difficilis ratio administrandi, quod paucos dies habebam reliquos annui muneris, illud autem difficillimum, relinquendus erat ex senatus consulto qui praeesset.	Quanto ao resto, não arranques os espinhos”.
Nihil minus probari poterat quam quaestor Mescinius.	2 Mas olha, trigo para o povo em Atenas?
Nam de Coelio nihil audiebamus.	Isso te agrada?
Rectissimum uidebatur Quintum fratrem cum imperio relinquere;	Ainda que certamente meus livros não impediam;
in quo multa molesta, discessus noster, belli periculum, militum improbitas, sescenta praeterea.	pois essa não foi uma generosidade para os cidadãos, mas uma liberalidade para os forasteiros.
O rem totam odiosam!	Contudo, me mandas pensar a respeito do pórtico da Academia, visto que Ápio já não pensa no de Elêusis?
Sed haec fortuna uiderit, quoniam consilio non multum uti licet.	Sei com certeza que tu sofres no que concerne a Hortênsio.
2 Tu quando Romam saluus (ut spero) uenisti, uidebis, ut soles, omnia quae intelleges nostra interesse, in primis de Tullia mea, cuius de condicione quid mihi placeret scripsi ad Terentiam cum tu in Graecia esses;	Eu certamente fico angustiado;
deinde de honore nostro.	pois eu tinha decidido viver na maior amizade com ele.
Quod enim tu afuisti, uereor ut satis diligenter actum in senatu sit de litteris meis.	3 Nós pusemos Célio à frente da província.
3 Illud praeterea μυστικώτερον ad te scribam, tu sagacius odorabere.	“Um menino” dirás “e talvez tolo e não sério e não controlado.”
τῆς δάμαρτός μου ὁ ἀπελεύθερος (οἶσθα ὃν λέγω) ἔδοξέ μοι πρώην, ἐξ ὧν ἀλογευόμενος παρεφθέγγετο, πεφυρακέναι τὰς ψήφους ἐκ τῆς ὠνῆς τῶν ὑπαρχόντων τῶν τοῦ Κροτωνιάτου τυραννοκτόνου.	Concordo;
δέδοικα δὴ μή τι - νοήσεις δήπου.	não se pôde fazer de outro modo.
τοῦτο δὴ περισκεψάμενος τὰ λοιπὰ ἐξασφάλισαι.	Pois a carta tua que eu tinha recebido muito antes, na qual tinhas escrito que não tinhas opinião formada sobre o que eu devia fazer acerca de minha sucessão, me atormentava.
Non queo tantum quantum uereor scribere;	Pois eu via quais eram os motivos de tua dúvida, e eram os mesmos para mim.
tu autem fac ut mihi tuae litterae uolent obuiae.	A confiaria a um menino?
Haec festinans scripsi in itinere atque agmine.	Isso não seria útil para a república.
Piliae et puellae Caeciliae bellissimae salutem dices.	Ao meu irmão?
5 Cicero Attico sal.	Aquilo não seria útil a nós.
1 Nunc quidem profecto Romae es, quo te, si ita est, saluum uenisse gaudeo;	Pois além de meu irmão não havia ninguém que eu anteporia, sem ultrae, ao meu questor, especialmente nobre.
unde quidem quam diu afuisti, magis a me abesse uidebare quam si domi esses.	Contudo, enquanto os partos pareciam ameaçar, eu tinha decidido deixar meu irmão, ou ainda eu próprio por causa da república permanecer contra o decreto do senado;
Minus enim mihi meae notae res erant, minus etiam publicae.	depois que eles, por incrível felicidade, se retiraram, minha dúvida foi desfeita.
Qua re uelim, etsi (ut spero) te haec legente aliquantum iam uiae processero, tamen obuias mihi litteras quam argutissimas de omnibus rebus crebro mittas, in primis de quo scripsi ad te antea.	Eu via os falatórios:
τῆς ξυναόρου τῆς ἐμῆς οὑξελεύθερος ἔδοξέ μοι θαμὰ βατταρίζων καὶ ἀλύων ἐν τοῖς ξυλλόγοις καὶ ταῖς λέσχαις ὑπό τι πεφυρακέναι τὰς ψήφους ἐν τοῖς ὑπάρχουσιν τοῖς τοῦ Κροτωνιάτου.	“Ah, deixou o irmão!
2 Hoc tu indaga, ut soles, at hoc magis:	Acaso isto não é ter a província por mais de um ano?
ἐξ ἄστεως ἑπταλόφου στείχων παρέδωκεν μνῶν †καμν† ὀφείλημα τῷ Καμίλλῳ, ἑαυτόν τε ὀφείλοντα μνᾶς κδ′ ἐκ τῶν Κροτωνιατικῶν καὶ ἐκ τῶν Χερρονησιτικῶν μη′ καὶ μνᾶς κληρονομῆσαι χμ′ [κμ].	O que o senado quer é que que estejam no comando das províncias os que não estiveram antes?
τούτων δὲ μηδὲ ὀβολὸν διευλυτῆσθαι, πάντων ὀφειληθέντων τοῦ δευτέρου μηνὸς τῇ νουμηνίᾳ.	Mas este por três anos.”
τὸν δὲ ἀπελεύθερον αὐτοῦ, ὄντα ὁμώνυμον τῷ Κόνωνος πατρί, μηδὲν ὁλοσχερῶς πεφροντικέναι.	4 Isto, portanto, para o povo:
ταῦτα οὖν πρῶτον μὲν ἵνα πάντα σῴζηται, δεύτερον δὲ ἵνα μηδὲ τῶν τόκων ὀλιγωρήσῃς τῶν ἀπὸ τῆς προεκκειμένης ἡμέρας.	e contigo?
ὅσας αὐτοῦ ἠνέγκαμεν σφόδρα δέδοικα· καὶ γὰρ παρῆν πρὸς ἡμᾶς κατασκεψόμενος καί τι σχεδὸν ἐλπίσας· ἀπογνοὺς δ' ἀλόγως ἀπῆλθεν ἐπειπών 'εἴκω·“αἰσχρόν τοι δηρόν τε μένειν.	Eu nunca estaria sem preocupação, se houvesse algo com mais ira ou com mais ofensa ou com mais negligência, coisas que a vida dos homens traz.
.	E se fosse o filho dele, um menino, e um menino bem confiante em si mesmo?
.”	Que dor seria?
, meque obiurgauit uetere prouerbio 'τὰ μὲν διδόμενα .	Seu pai não o deixaria ir e se indignaria de que pensasses isso.
.	Mas agora Célio, não digo “o que fêz”, mas mesmo assim sofro muito menos.
.”	Acrescenta isto:
.	Pompeu, um homem com essa força, com essas raízes, escolheu Quinto Cássio sem sorteio, César escolheu Antônio:
3 Reliqua uide et quantum fieri potest perspice.	iria eu ofender a quem tinha sido entregue a mim por sorteio para que ele espionasse aquele que eu tivesse deixado?
Nos etsi annuum tempus [est] prope iam emeritum habebamus (dies enim XXXIII erant reliqui), sollicitudine prouinciae tamen uel maxime urgebamur.	Isto é melhor e há muitos exemplos disso, sem dúvida, na verdade, o mais adequado para a nossa velhice.
Cum enim arderet Syria bello et Bibulus in tanto maerore suo maximam curam belli sustineret ad meque legati eius et quaestor et amici eius litteras mitterent ut subsidio uenirem, etsi exercitum infirmum habebam, auxilia sane bona sed ea Galatarum, Pisidarum, Lyciorum (haec enim sunt nostra robora), tamen esse officium meum putaui exercitum habere quam proxime hostem quoad mihi praeesse prouinciae per senatus consultum liceret.	Em que grande harmonia te pus com ele, bons deuses!
Sed quo ego maxime delectabar, Bibulus molestus mihi non erat, de omnibus rebus scribebat ad me potius.	Li para ele a carta não tua, mas de teu secretário.
Et mihi decessionis dies λεληθότως obrepebat.	As cartas de meus amigos me convocam ao triunfo, uma coisa que, segundo eu julgo, não deve ser negligenciada por nós por causa desse nosso renascimento.
Qui cum aduenerit, ἄλλο πρόβλημα, quem praeficiam, nisi Caldus quaestor uenerit;	Por isso, tu também, meu querido Ático, começa a desejar isso, para que eu pareça menos tolo.
de quo adhuc nihil certi habebamus.	7 Cícero saúda Ático.
4 Cupiebam mehercule longiorem epistulam facere, sed nec erat res de qua scriberem nec iocari prae cura poteram.	1 Quinto filho sem dúvida com seu amor filial (tendo eu certamente, na verdade, o exortado muito, mas ele foi rápido) reconciliou o espírito de seu pai com a tua irmã.
Valebis igitur et puellae salutem Atticulae tuae dices nostraeque Piliae.	Tua carta também o animou muito.
6 Cicero Attico sal.	Que queres?
1 Ego dum in prouincia omnibus rebus Appium orno, subito sum factus accusatoris eius socer.	Confio que a coisa está como queremos.
“Id quidem” inquis “di adprobent!”	Escrevi antes duas vezes sobre um assunto meu privado em grego, em enigmas, se é que as cartas te foram entregues.
.	Evidentemente nada deve ser mexido;
Ita uelim, teque ita cupere certo scio.	mas perguntando simplesmente sobre os títulos de Milão e exortando-o a que desembarace como me prometu, conseguirás algo ou, ao menos, averiguarás.
Sed crede mihi, nihil minus putaram ego, qui de Ti.	2 Eu ordenei que o questor Mescínio esperasse em Laodicéia, para que eu possa deixar terminadas as contas, segundo a lei Júlia, nas duas cidades.
Nerone, qui mecum egerat, certos homines ad mulieres miseram;	Quero ir para Rodes por causa dos meninos, de lá o quanto antes para Atenas, ainda que os ventos etésios soprem fortemente contra;
qui Romam uenerunt factis sponsalibus.	mas claramente quero isso com esses magistrados, cuja boa vontade constatei nas preces públicas.
Sed hoc spero melius.	Tu, contudo, manda, peço-te, uma carta ao meu encontro, se por acaso julgas que em nome da república eu devo retardar-me.
Mulieres quidem ualde intellego delectari obsequio et comitate adulescentis.	Tirão teria entregado uma carta a ti, se eu não o tivesse deixado em Isso gravemente doente;
Cetera noli ἐξακανθίζειν.	mas me anunciam que está melhor.
2 Sed heus tu, πυροὺς εἰς δῆμον Athenis?	Eu, contudo, me angustio;
Placet hoc tibi?	pois não há mais puro, nada mais diligente do que aquele jovem.
Etsi non impediebant mei certe libri;	8 Cícero saúda Ático.
non enim ista largitio fuit in ciuis sed in hospites liberalitas.	1 Quando eu tinha decidido te escrever e tinha pegado o cálamo, chegou Batônio diretamente do navio até minha casa em Éfeso e me entregou tua carta do segundo dia antes das calendas de outubro [30 de setembro] Alegrei-me com felicidade de tua travessia, com o oportuno encontro com Pília, e também, por hércules, com a fala dela sobre o casamento de minha Túlia.
Me tamen de Academiae προπύλῳ iubes cogitare, cum iam Appius de Eleusine non cogitet?	2 Batônio, porém, me trouxe verdadeiros terrores cesarianos, falou com Lepta ainda mais coisas, espero que falsas, mas certamente terríveis:
De Hortensio te certo scio dolere.	que ele não vai de modo algum dispensar o exército, que estão com ele três pretores designados, o tribuno da plebe Cássio e o cônsul Lêntulo, que Pompeu tem em mente abandonar a cidade.
Equidem excrucior;	3 Mas olha, por acaso não estás indignado a respeito daquele que costuma se antepor ao tio do filho de tua irmã?
decreram enim ualde cum eo familiariter uiuere.	E por quem é vencido!
3 Nos prouinciae praefecimus Coelium.	4 Mas vamos ao assuto.
“Puerum” inquies “et fortasse fatuum et non grauem et non continentem.”	Violentíssimos ventos etésios nos retardaram;
Adsentior;	o barco descoberto me fez perder 20 dias exatos em Rodes.
fieri non potuit aliter.	Nas calendas de outubro, embarcando em Éfeso, entregamos esta carta a Lúcio Tarquício, saindo do porto ao mesmo tempo, mas navegando mais rapidamente.
Nam quas multo ante tuas acceperam litteras in quibus ἐπέχειν te scripseras quid esset mihi faciendum de relinquendo, eae me pungebant.	Nós, com os barcos descobertos dos ródios e com as demais naus de forma longa, estávamos à espreita de bonança;
Videbam enim quae tibi essent ἐποχῆς causae, et erant eaedem mihi.	contudo, nos apressávamos de tal modo que mais não era possível.
Puero traderem?	5 Quanto à dividazinha da chácara de Putéolos, agradecido.
Id rei publicae non utile.	Agora eu queria que observes os assuntos romanos, que vejas o que achas que devemos pensar a respeito do triunfo ao qual meus amigos convidam.
Fratri autem?	Eu, se Bíbulo, que, enquanto houve um único inimigo na Síria, não pôs o pé fora da porta, quando cônsul, fora de sua casa, não se esforçasse por seu triunfo, eu estaria tranquilo;
Illud non utile nobis.	mas agora “é uma vergonha calar” Mas examina a coisa toda, para que, no dia em que nos reunirmos, possamos tomar uma decisão.
Nam praeter fratrem nemo erat quem sine contumelia quaestori, nobili praesertim, anteferrem.	Isso é suficiente, porque tenho pressa e entrego esta carta a alguém que vai chegar ou junto comigo ou um pouco antes.
Tamen, dum impendere Parthi uidebantur, statueram fratrem relinquere, aut etiam rei publicae causa contra senatus consultum ipse remanere;	Cícero te manda muita saúde, tu a mandarás da parte de nós dois tanto à tua Pília como à tua filha.
qui postea quam incredibili felicitate discesserunt, sublata dubitatio est.	9 Cícero saúda Ático.
Videbam sermones:	1 Assim que desembarquei no Pireu, na véspera dos idos de outubro [14 de outubro], recebi de imediato de meu escravo Acasto a tua carta.
“Hui, fratrem reliquit!	Como, na verdade, eu já a esperasse há muito tempo, fiquei admirado quando vi a carta ainda fechada, a brevidade dela, quando abri, igualmente a irregularidade de suas letrinhas e as tuas costumam ser muito cuidadas e muito claras e, para não me alongar, pelo fato de teres escrito assim, soube que tinhas chegado a Roma no décimo segundo dia antes das calendas de outubro [19 de setembro] com febre.
Num est hoc non plus annum obtinere prouinciam?	Fortemente afetado, não mais do que devia, pergunto logo em seguida a Acasto.
Quid quod senatus eos uoluit praeesse prouinciis qui non praefuissent?	Ele [disse] que a ti e ele próprio pareceu e assim ouviu dos teus em casa que não era nada preocupante.
At hic triennium.”	Parecia aprovar isso o que estava no fim, que escreveste então tendo uma febrícula.
4 Ergo haec ad populum:	Contudo apreciei e fiquei contente por teres mesmo assim me escrito com tua própria mão.
quid quae tecum?	Por isso basta disso;
Numquam essem sine cura, si quid iracundius aut contumeliosius aut neglegentius, quae fert uita hominum.	pois espero, o que é tua prudência e moderação, e, por hércules, conforme me aconselha Acasto, confio que logo estarás bom como desejamos.
Quid si quid filius puer et puer bene sibi fidens?	2 Fico contente que tenhas recebido minha carta das mãos de Turrânio.
Qui esset dolor Quem pater non dimittebat teque id censere moleste ferebat.	(.
At nunc Coelius non dico equidem “quod egerit”, sed tamen multo minus laboro.	.
Adde illud.	.
Pompeius, eo robore uir, iis radicibus, Q.	) se me amas, (.
Cassium sine sorte delegit, Caesar Antonium:	.
ego sorte datum offenderem, ut etiam inquireret in eum quem reliquissem?	.
Hoc melius, et huius rei plura exempla, senectuti quidem nostrae profecto aptius.	) cuida da herança de Precio, por perquena que seja, a qual, por hércules, me causa grande dor (pois eu estimei o homem);
At te apud eum, di boni, quanta in gratia posui!	que ele não a toque.
Eique legi litteras non tuas sed librari tui.	Dirás que tenho necessidade de dinheiro para o aparato do triunfo;
Amicorum litterae me ad triumphum uocant, rem a nobis, ut ego arbitror, propter hanc παλιγγενεσίαν nostram non neglegendam.	nele, de acordo com teus preceitos, não me reconhecerás como vaidoso ao solicitá-lo nem modesto ao rechaçá-lo.
Qua re tu quoque, mi Attice, incipe id cupere, quo nos minus inepti uideamur.	3 Entendi por tua carta que ouviste de Turrânio que a província foi entregue por mim a meu irmão.
7 Cicero Attico sal.	A tal ponto eu não ia notar a prudência de tua carta?
1 Quintus filius pie sane (me quidem certe multum hortante, sed currentem) animum patris sui sorori tuae reconciliauit.	(.
Eum ualde etiam tuae litterae excitarunt.	.
Quid quaeris?	.
Confido rem ut uolumus esse.	) escrevias;
Bis ad te antea scripsi de re mea familiari, si modo tibi redditae litterae sunt, Graece ἐν αἰνιγμοῖς.	o que era digno de dúvida, se havia por que agradava que um irmão e um irmão como o meu fosse deixado no cargo?
Scilicet nihil est mouendum;	Quanto ao menino Quinto Cícero me aconselhas que eu não o deixe de jeito nenhum:
sed tamen ἀφελῶς percontando de nominibus Milonis et ut expediat ut mihi receperit hortando aliquid aut proficies aut certe perspicies.	(.
2 Ego Laodiceae quaestorem Mescinium exspectare iussi, ut confectas rationes lege Iulia apud duas ciuitates possim relinquere.	.
Rhodum uolo puerorum causa, inde quam primum Athenas, etsi etesiae ualde reflant;	.
sed plane uolo his magistratibus, quorum uoluntatem in supplicatione sum expertus.	) Vimos as mesmas coisas como se tivéssemos conversado.
Tu tamen mitte, quaeso, mihi obuiam litteras num quid putes rei publicae nomine tardandum esse nobis.	Não se devia fazer diferente, e tua (.
Tiro ad te dedisset litteras, nisi eum grauiter aegrum Issi reliquissem;	.
sed nuntiant melius esse.	.
Ego tamen angor;	) me livrou da dúvida.
nihil enim illo adulescente castius, nihil diligentius.	Mas acho que recebeste uma carta sobre esse assunto escrita mais caprichadamente.
8 Cicero Attico sal.	4 Eu vou mandar carteiros para vós amanhã.
1 Cum instituissem ad te scribere calamumque sumpsissem, Batonius e naui recta ad me uenit domum Ephesi et epistulam tuam reddidit II Kal.	os quais eu acho que chegarão antes que o nosso Saufeio, mas era pouco correto que ele chegasse até ti sem minha carta.
Oct.	5 Tu me escreverás detalhadamente, como prometeste, sobre minha Tuliazinha, isto é, sobre Dolabela, sobre a república, que prevejo em extremos perigos, sobre os censores e principalmente sobre as estátuas, quadros, o que acontece, o que se submete à deliberação.
Laetatus sum felicitate nauigationis tuae, opportunitate Piliae, etiam hercule sermone eiusdem de coniugio Tulliae meae.	Entreguei esta carta nos idos de outubro [15 de outubro], o dia em que, conforme escreves, César leva quatro legiões à Placência.
2 Batonius autem meros terrores ad me attulit Caesarianos, cum Lepta etiam plura locutus est, spero falsa sed certe horribilia:	Pergunto, o que será de nós?
exercitum nullo modo dimissurum, cum illo praetores designatos tris, Cassium tribunum pl.	Meu alojamento na cidadela em Atenas agora me agrada.
, Lentulum consulem facere, Pompeio in animo esse urbem relinquere.	
3 Sed heus tu, num quid moleste fers de illo qui se solet anteferre patruo sororis tuae fili?	1
At a quibus uictus!	2
4 Sed ad rem.	3
Nos etesiae uehementissimi tardarunt;	4
detraxit XX ipsos dies etiam aphractus Rhodi.	5
Kal.	6
Oct.	7
Epheso conscendentes hanc epistulam dedimus L.	8
Tarquitio simul e portu egredienti sed expeditius nauiganti.	9
Nos Rhodiorum aphractis ceterisque longis nauibus tranquillitates aucupaturi eramus;	10
ita tamen properabamus ut non posset magis.	11
5 De raudusculo Puteolano gratum.	12
Nunc uelim dispicias res Romanas, uideas quid nobis de triumpho cogitandum putes, ad quem amici me uocant.	13
Ego, nisi Bibulus, qui dum unus hostis in Syria fuit pedem porta non plus extulit quam consul domo sua, adniteretur de triumpho, aequo essem animo;	14
nunc uero “αἰσχρὸν σιωπᾶν”.	15
Sed explora rem totam, ut quo die congressi erimus consilium capere possimus.	16
Sat multa, qui et properarem et ei litteras darem qui aut mecum aut paulo ante uenturus esset.	17
Cicero tibi plurimam salutem dicit, tu dices utriusque nostrum uerbis et Piliae tuae et filiae.	18
9 Cicero Attico sal.	19
1 In Piraeea cum exissem prid.	20
Id.	21
Oct.	22
, accepi ab Acasto seruo meo statim tuas litteras.	23
Quas quidem cum exspectassem iam diu, admiratus sum, ut uidi obsignatam epistulam, breuitatem eius, ut aperui, rursus σύγχυσιν litterularum, quae solent tuae compositissimae et clarissimae esse;	24
ac, ne multa, cognoui ex eo quod ita scripseras te Romam uenisse a.	25
d.	26
XII Kal.	27
Oct.	28
cum febri.	29
Percussus uehementer, nec magis quam debui, statim quaero ex Acasto.	30
Ille et tibi et sibi uisum et ita se domi ex tuis audisse ut nihil esset incommodi;	31
id uidebatur adprobare quod erat in extremo, febriculam tum te habentem scripsisse.	32
Sed te amaui tamen admiratusque sum quod nihilo minus ad me tua manu scripsisses.	33
Qua re de hoc satis;	34
spero enim, quae tua prudentia et temperantia est, et hercule, ut me iubet Acastus, confido te iam ut uolumus ualere.	35
2 A Turranio te accepisse meas litteras gaudeo.	36
παραφύλαξον, si me amas, τὴν τοῦ φυρατοῦ φιλοτιμίαν·αὐτίκα γὰρ hanc, quae mehercule mihi magno dolori est (dilexi enim hominem), procura, quantulacumque est, Precianam hereditatem;	37
prorsus ille ne attingat.	38
Dices nummos mihi opus esse ad apparatum triumphi;	39
in quo, ut praecipis, nec me κενὸν in expetendo cognosces nec ἄτυφον in abiciendo.	40
3 Intellexi ex tuis litteris te ex Turranio audisse a me prouinciam fratri traditam.	41
Adeon ego non perspexeram prudentiam litterarum tuarum?	42
ἐπέχειν te scribebas;	43
quid erat dubitatione dignum, si esset quicquam cur placeret fratrem et talem fratrem relinqui?	44
ἀθέτησις ista mihi tua, non ἐποχὴ uidebatur.	45
Monebas de Q.	46
Cicerone puero ut eum quidem neutiquam relinquerem:	47
“τοὐμὸν ὄνειρον ἐμοί.”	48
Eadem omnia quasi collocuti essemus uidimus.	49
Non fuit faciendum aliter, meque ἐπιχρονία ἐποχὴ tua dubitatione liberauit.	50
Sed puto te accepisse de hac re epistulam scriptam accuratius.	51
4 Ego tabellarios postero die ad uos eram missurus;	52
quos puto ante uenturos quam nostrum Saufeium, sed eum sine meis litteris ad te uenire uix rectum erat.	53
5 Tu mihi, ut polliceris, de Tulliola mea, id est de Dolabella, perscribes, de re publica, quam prouideo in summis periculis, de censoribus, maximeque de signis, tabulis quid fiat, referaturne.	54
Id.	55
Oct.	56
has dedi litteras, quo die, ut scribis, Caesar Placentiam legiones IIII.	57
Quaeso, quid nobis futurum est?	58
In arce Athenis statio mea nunc placet.	59
	60
